Date,Year,Quarter,Nationality,Region,Initial decisions from designated states,Refusals from designated states,Clearly unfounded refusals (designated states),Clearly unfounded refusals (non-designated states),Total clearly unfounded refusals
2010-03-31,2010,1,Albania,Europe Other,40,34,18,0,18
2010-03-31,2010,1,Algeria,Africa North,0,0,0,7,7
2010-03-31,2010,1,Australia,Oceania,0,0,0,1,1
2010-03-31,2010,1,Bangladesh,Asia South,0,0,0,12,12
2010-03-31,2010,1,Benin,Africa Sub-Saharan,0,0,0,1,1
2010-03-31,2010,1,Bolivia,America Central and South,4,4,2,0,2
2010-03-31,2010,1,Bosnia and Herzegovina,Europe Other,1,0,0,0,0
2010-03-31,2010,1,Brazil,America Central and South,4,4,3,0,3
2010-03-31,2010,1,Chile,America Central and South,0,0,0,2,2
2010-03-31,2010,1,China,Asia East,0,0,0,7,7
2010-03-31,2010,1,Congo (Democratic Republic),Africa Sub-Saharan,0,0,0,1,1
2010-03-31,2010,1,Dominica,America Central and South,0,0,0,1,1
2010-03-31,2010,1,Ecuador,America Central and South,2,2,1,0,1
2010-03-31,2010,1,Egypt,Africa North,0,0,0,2,2
2010-03-31,2010,1,Eritrea,Africa Sub-Saharan,0,0,0,1,1
2010-03-31,2010,1,"Gambia, The",Africa Sub-Saharan,29,25,7,0,7
2010-03-31,2010,1,Georgia,Europe Other,0,0,0,2,2
2010-03-31,2010,1,Ghana,Africa Sub-Saharan,22,21,11,0,11
2010-03-31,2010,1,Guinea,Africa Sub-Saharan,0,0,0,1,1
2010-03-31,2010,1,India,Asia South,85,84,45,0,45
2010-03-31,2010,1,Iran,Middle East,0,0,0,1,1
2010-03-31,2010,1,Iraq,Middle East,0,0,0,2,2
2010-03-31,2010,1,Israel,Middle East,0,0,0,1,1
2010-03-31,2010,1,Jamaica,America Central and South,48,44,8,0,8
2010-03-31,2010,1,Jordan,Middle East,0,0,0,1,1
2010-03-31,2010,1,Kenya,Africa Sub-Saharan,9,9,5,0,5
2010-03-31,2010,1,Korea (North),Asia East,0,0,0,10,10
2010-03-31,2010,1,Kosovo,Europe Other,1,0,0,0,0
2010-03-31,2010,1,Liberia,Africa Sub-Saharan,0,0,0,1,1
2010-03-31,2010,1,Malawi,Africa Sub-Saharan,9,8,2,6,8
2010-03-31,2010,1,Malaysia,Asia South East,0,0,0,1,1
2010-03-31,2010,1,Mali,Africa Sub-Saharan,1,1,0,0,0
2010-03-31,2010,1,Mauritius,Africa Sub-Saharan,3,3,1,0,1
2010-03-31,2010,1,Mexico,America Central and South,0,0,0,1,1
2010-03-31,2010,1,Moldova,Europe Other,2,2,1,0,1
2010-03-31,2010,1,Mongolia,Asia East,9,8,3,0,3
2010-03-31,2010,1,Morocco,Africa North,0,0,0,1,1
2010-03-31,2010,1,Namibia,Africa Sub-Saharan,0,0,0,1,1
2010-03-31,2010,1,Nigeria,Africa Sub-Saharan,96,92,47,16,63
2010-03-31,2010,1,North Macedonia,Europe Other,1,1,1,0,1
2010-03-31,2010,1,Pakistan,Asia South,0,0,0,15,15
2010-03-31,2010,1,Panama,America Central and South,0,0,0,1,1
2010-03-31,2010,1,Philippines,Asia South East,0,0,0,1,1
2010-03-31,2010,1,Poland,EU 8,0,0,0,1,1
2010-03-31,2010,1,Romania,EU 2,0,0,0,2,2
2010-03-31,2010,1,Russia,Europe Other,0,0,0,4,4
2010-03-31,2010,1,Senegal,Africa Sub-Saharan,0,0,0,4,4
2010-03-31,2010,1,Sierra Leone,Africa Sub-Saharan,10,9,5,0,5
2010-03-31,2010,1,South Africa,Africa Sub-Saharan,46,38,19,0,19
2010-03-31,2010,1,South Korea,Asia East,0,0,0,1,1
2010-03-31,2010,1,Sri Lanka,Asia South,0,0,0,1,1
2010-03-31,2010,1,Tanzania,Africa Sub-Saharan,0,0,0,1,1
2010-03-31,2010,1,Thailand,Asia South East,0,0,0,1,1
2010-03-31,2010,1,Tunisia,Africa North,0,0,0,2,2
2010-03-31,2010,1,Uganda,Africa Sub-Saharan,0,0,0,1,1
2010-03-31,2010,1,Ukraine,Europe Other,8,8,5,0,5
2010-03-31,2010,1,United States,America North,0,0,0,1,1
2010-03-31,2010,1,Venezuela,America Central and South,0,0,0,1,1
2010-03-31,2010,1,Vietnam,Asia South East,0,0,0,1,1
2010-03-31,2010,1,Zambia,Africa Sub-Saharan,0,0,0,1,1
2010-06-30,2010,2,Albania,Europe Other,44,33,7,0,7
2010-06-30,2010,2,Algeria,Africa North,0,0,0,7,7
2010-06-30,2010,2,Bangladesh,Asia South,0,0,0,8,8
2010-06-30,2010,2,Bolivia,America Central and South,5,5,3,0,3
2010-06-30,2010,2,Bosnia and Herzegovina,Europe Other,3,2,0,0,0
2010-06-30,2010,2,Brazil,America Central and South,11,10,9,0,9
2010-06-30,2010,2,Chile,America Central and South,0,0,0,1,1
2010-06-30,2010,2,China,Asia East,0,0,0,3,3
2010-06-30,2010,2,Colombia,America Central and South,0,0,0,1,1
2010-06-30,2010,2,Egypt,Africa North,0,0,0,1,1
2010-06-30,2010,2,Former Yugoslavia,Europe Other,0,0,0,1,1
2010-06-30,2010,2,"Gambia, The",Africa Sub-Saharan,23,17,0,0,0
2010-06-30,2010,2,Georgia,Europe Other,0,0,0,1,1
2010-06-30,2010,2,Ghana,Africa Sub-Saharan,32,31,17,1,18
2010-06-30,2010,2,Hungary,EU 8,0,0,0,1,1
2010-06-30,2010,2,India,Asia South,57,54,35,0,35
2010-06-30,2010,2,Iran,Middle East,0,0,0,1,1
2010-06-30,2010,2,Ivory Coast,Africa Sub-Saharan,0,0,0,1,1
2010-06-30,2010,2,Jamaica,America Central and South,51,45,15,0,15
2010-06-30,2010,2,Jordan,Middle East,0,0,0,1,1
2010-06-30,2010,2,Kenya,Africa Sub-Saharan,8,8,2,1,3
2010-06-30,2010,2,Korea (North),Asia East,0,0,0,4,4
2010-06-30,2010,2,Kosovo,Europe Other,0,0,0,3,3
2010-06-30,2010,2,Liberia,Africa Sub-Saharan,5,4,3,0,3
2010-06-30,2010,2,Malawi,Africa Sub-Saharan,16,14,4,5,9
2010-06-30,2010,2,Maldives,Asia South,0,0,0,1,1
2010-06-30,2010,2,Mali,Africa Sub-Saharan,1,1,0,0,0
2010-06-30,2010,2,Mauritius,Africa Sub-Saharan,12,12,8,0,8
2010-06-30,2010,2,Moldova,Europe Other,2,2,0,0,0
2010-06-30,2010,2,Mongolia,Asia East,4,4,1,0,1
2010-06-30,2010,2,Namibia,Africa Sub-Saharan,0,0,0,1,1
2010-06-30,2010,2,Nigeria,Africa Sub-Saharan,86,81,43,25,68
2010-06-30,2010,2,North Macedonia,Europe Other,1,1,0,0,0
2010-06-30,2010,2,Pakistan,Asia South,0,0,0,16,16
2010-06-30,2010,2,Senegal,Africa Sub-Saharan,0,0,0,2,2
2010-06-30,2010,2,Sierra Leone,Africa Sub-Saharan,1,1,0,0,0
2010-06-30,2010,2,South Africa,Africa Sub-Saharan,32,30,8,0,8
2010-06-30,2010,2,South Korea,Asia East,2,2,2,2,4
2010-06-30,2010,2,Turkey,Europe Other,0,0,0,2,2
2010-06-30,2010,2,Uganda,Africa Sub-Saharan,0,0,0,3,3
2010-06-30,2010,2,Ukraine,Europe Other,8,4,1,0,1
2010-06-30,2010,2,United States,America North,0,0,0,3,3
2010-06-30,2010,2,Vietnam,Asia South East,0,0,0,5,5
2010-09-30,2010,3,Albania,Europe Other,45,34,9,0,9
2010-09-30,2010,3,Algeria,Africa North,0,0,0,3,3
2010-09-30,2010,3,Bangladesh,Asia South,0,0,0,15,15
2010-09-30,2010,3,Bolivia,America Central and South,5,5,3,0,3
2010-09-30,2010,3,Bosnia and Herzegovina,Europe Other,3,3,1,0,1
2010-09-30,2010,3,Brazil,America Central and South,9,8,6,0,6
2010-09-30,2010,3,Burma,Asia South East,0,0,0,1,1
2010-09-30,2010,3,Chile,America Central and South,0,0,0,1,1
2010-09-30,2010,3,China,Asia East,0,0,0,7,7
2010-09-30,2010,3,Croatia,EU Other,0,0,0,1,1
2010-09-30,2010,3,"Gambia, The",Africa Sub-Saharan,26,23,6,0,6
2010-09-30,2010,3,Georgia,Europe Other,0,0,0,5,5
2010-09-30,2010,3,Ghana,Africa Sub-Saharan,37,35,13,0,13
2010-09-30,2010,3,India,Asia South,90,86,48,0,48
2010-09-30,2010,3,Jamaica,America Central and South,75,56,18,0,18
2010-09-30,2010,3,Kenya,Africa Sub-Saharan,14,12,4,1,5
2010-09-30,2010,3,Korea (North),Asia East,0,0,0,4,4
2010-09-30,2010,3,Kosovo,Europe Other,7,6,3,0,3
2010-09-30,2010,3,Kyrgyzstan,Asia Central,0,0,0,1,1
2010-09-30,2010,3,Liberia,Africa Sub-Saharan,3,3,0,0,0
2010-09-30,2010,3,Libya,Africa North,0,0,0,1,1
2010-09-30,2010,3,Malawi,Africa Sub-Saharan,15,13,2,4,6
2010-09-30,2010,3,Malaysia,Asia South East,0,0,0,2,2
2010-09-30,2010,3,Mali,Africa Sub-Saharan,1,1,1,0,1
2010-09-30,2010,3,Mauritius,Africa Sub-Saharan,12,12,5,0,5
2010-09-30,2010,3,Moldova,Europe Other,1,0,0,0,0
2010-09-30,2010,3,Mongolia,Asia East,10,9,1,0,1
2010-09-30,2010,3,Morocco,Africa North,0,0,0,1,1
2010-09-30,2010,3,Namibia,Africa Sub-Saharan,0,0,0,1,1
2010-09-30,2010,3,Netherlands,EU 14,0,0,0,1,1
2010-09-30,2010,3,Nicaragua,America Central and South,0,0,0,1,1
2010-09-30,2010,3,Nigeria,Africa Sub-Saharan,103,94,46,22,68
2010-09-30,2010,3,North Macedonia,Europe Other,1,1,0,0,0
2010-09-30,2010,3,Occupied Palestinian Territories,Middle East,0,0,0,1,1
2010-09-30,2010,3,Pakistan,Asia South,0,0,0,14,14
2010-09-30,2010,3,Refugee,Other,0,0,0,1,1
2010-09-30,2010,3,Russia,Europe Other,0,0,0,2,2
2010-09-30,2010,3,Serbia and Montenegro,Europe Other,1,1,1,0,1
2010-09-30,2010,3,Sierra Leone,Africa Sub-Saharan,9,8,4,2,6
2010-09-30,2010,3,South Africa,Africa Sub-Saharan,30,28,12,0,12
2010-09-30,2010,3,South Korea,Asia East,0,0,0,1,1
2010-09-30,2010,3,Sri Lanka,Asia South,0,0,0,1,1
2010-09-30,2010,3,Sudan,Africa North,0,0,0,1,1
2010-09-30,2010,3,Trinidad and Tobago,America Central and South,0,0,0,1,1
2010-09-30,2010,3,Ukraine,Europe Other,9,9,2,0,2
2010-09-30,2010,3,United States,America North,0,0,0,1,1
2010-09-30,2010,3,Vietnam,Asia South East,0,0,0,7,7
2010-09-30,2010,3,Zambia,Africa Sub-Saharan,0,0,0,1,1
2010-09-30,2010,3,Zimbabwe,Africa Sub-Saharan,0,0,0,2,2
2010-12-31,2010,4,Afghanistan,Asia Central,0,0,0,1,1
2010-12-31,2010,4,Albania,Europe Other,53,43,13,0,13
2010-12-31,2010,4,Algeria,Africa North,0,0,0,6,6
2010-12-31,2010,4,Antigua and Barbuda,America Central and South,0,0,0,1,1
2010-12-31,2010,4,Bangladesh,Asia South,0,0,0,13,13
2010-12-31,2010,4,Bolivia,America Central and South,3,3,3,0,3
2010-12-31,2010,4,Bosnia and Herzegovina,Europe Other,2,2,0,0,0
2010-12-31,2010,4,Botswana,Africa Sub-Saharan,0,0,0,1,1
2010-12-31,2010,4,Brazil,America Central and South,9,8,3,0,3
2010-12-31,2010,4,Burundi,Africa Sub-Saharan,0,0,0,1,1
2010-12-31,2010,4,Canada,America North,0,0,0,2,2
2010-12-31,2010,4,China,Asia East,0,0,0,4,4
2010-12-31,2010,4,Ecuador,America Central and South,1,1,0,0,0
2010-12-31,2010,4,Egypt,Africa North,0,0,0,1,1
2010-12-31,2010,4,El Salvador,America Central and South,0,0,0,1,1
2010-12-31,2010,4,"Gambia, The",Africa Sub-Saharan,16,12,2,1,3
2010-12-31,2010,4,Ghana,Africa Sub-Saharan,17,17,10,1,11
2010-12-31,2010,4,India,Asia South,118,113,70,2,72
2010-12-31,2010,4,Israel,Middle East,0,0,0,1,1
2010-12-31,2010,4,Jamaica,America Central and South,60,47,12,0,12
2010-12-31,2010,4,Jordan,Middle East,0,0,0,1,1
2010-12-31,2010,4,Kenya,Africa Sub-Saharan,5,5,0,1,1
2010-12-31,2010,4,Korea (North),Asia East,0,0,0,1,1
2010-12-31,2010,4,Kosovo,Europe Other,6,6,4,0,4
2010-12-31,2010,4,Liberia,Africa Sub-Saharan,1,0,0,0,0
2010-12-31,2010,4,Malawi,Africa Sub-Saharan,7,5,1,1,2
2010-12-31,2010,4,Mali,Africa Sub-Saharan,2,2,1,0,1
2010-12-31,2010,4,Mauritius,Africa Sub-Saharan,10,10,7,0,7
2010-12-31,2010,4,Moldova,Europe Other,3,1,0,0,0
2010-12-31,2010,4,Mongolia,Asia East,10,9,4,0,4
2010-12-31,2010,4,Morocco,Africa North,0,0,0,1,1
2010-12-31,2010,4,Nigeria,Africa Sub-Saharan,116,106,46,15,61
2010-12-31,2010,4,Pakistan,Asia South,0,0,0,12,12
2010-12-31,2010,4,Romania,EU 2,0,0,0,1,1
2010-12-31,2010,4,Senegal,Africa Sub-Saharan,0,0,0,1,1
2010-12-31,2010,4,Sierra Leone,Africa Sub-Saharan,9,9,5,0,5
2010-12-31,2010,4,Somalia,Africa Sub-Saharan,0,0,0,2,2
2010-12-31,2010,4,South Africa,Africa Sub-Saharan,27,22,10,0,10
2010-12-31,2010,4,South Korea,Asia East,1,1,0,0,0
2010-12-31,2010,4,Sri Lanka,Asia South,0,0,0,1,1
2010-12-31,2010,4,Sudan,Africa North,0,0,0,1,1
2010-12-31,2010,4,Syria,Middle East,0,0,0,2,2
2010-12-31,2010,4,Tunisia,Africa North,0,0,0,1,1
2010-12-31,2010,4,Turkey,Europe Other,0,0,0,1,1
2010-12-31,2010,4,Uganda,Africa Sub-Saharan,0,0,0,5,5
2010-12-31,2010,4,Ukraine,Europe Other,12,12,10,0,10
2010-12-31,2010,4,United States,America North,0,0,0,2,2
2010-12-31,2010,4,Vietnam,Asia South East,0,0,0,5,5
2011-03-31,2011,1,Afghanistan,Asia Central,0,0,0,3,3
2011-03-31,2011,1,Albania,Europe Other,36,28,9,0,9
2011-03-31,2011,1,Algeria,Africa North,0,0,0,11,11
2011-03-31,2011,1,Angola,Africa Sub-Saharan,0,0,0,1,1
2011-03-31,2011,1,Azerbaijan,Europe Other,0,0,0,1,1
2011-03-31,2011,1,Bangladesh,Asia South,0,0,0,15,15
2011-03-31,2011,1,Bolivia,America Central and South,8,7,4,0,4
2011-03-31,2011,1,Bosnia and Herzegovina,Europe Other,1,0,0,0,0
2011-03-31,2011,1,Botswana,Africa Sub-Saharan,0,0,0,1,1
2011-03-31,2011,1,Canada,America North,0,0,0,1,1
2011-03-31,2011,1,Chile,America Central and South,0,0,0,1,1
2011-03-31,2011,1,China,Asia East,0,0,0,5,5
2011-03-31,2011,1,Ecuador,America Central and South,2,1,1,0,1
2011-03-31,2011,1,Former Yugoslavia,Europe Other,0,0,0,1,1
2011-03-31,2011,1,"Gambia, The",Africa Sub-Saharan,34,26,9,2,11
2011-03-31,2011,1,Georgia,Europe Other,0,0,0,2,2
2011-03-31,2011,1,Ghana,Africa Sub-Saharan,26,24,7,4,11
2011-03-31,2011,1,India,Asia South,91,89,57,0,57
2011-03-31,2011,1,Indonesia,Asia South East,0,0,0,1,1
2011-03-31,2011,1,Iran,Middle East,0,0,0,1,1
2011-03-31,2011,1,Jamaica,America Central and South,38,26,8,1,9
2011-03-31,2011,1,Kenya,Africa Sub-Saharan,13,10,5,0,5
2011-03-31,2011,1,Korea (North),Asia East,0,0,0,4,4
2011-03-31,2011,1,Kosovo,Europe Other,3,2,1,0,1
2011-03-31,2011,1,Liberia,Africa Sub-Saharan,5,4,1,0,1
2011-03-31,2011,1,Malawi,Africa Sub-Saharan,17,12,2,1,3
2011-03-31,2011,1,Malaysia,Asia South East,0,0,0,1,1
2011-03-31,2011,1,Mali,Africa Sub-Saharan,3,3,3,0,3
2011-03-31,2011,1,Mauritius,Africa Sub-Saharan,8,6,5,0,5
2011-03-31,2011,1,Moldova,Europe Other,1,1,1,0,1
2011-03-31,2011,1,Mongolia,Asia East,10,8,3,0,3
2011-03-31,2011,1,Morocco,Africa North,0,0,0,1,1
2011-03-31,2011,1,Nigeria,Africa Sub-Saharan,83,74,36,23,59
2011-03-31,2011,1,Pakistan,Asia South,0,0,0,24,24
2011-03-31,2011,1,Peru,America Central and South,1,1,0,0,0
2011-03-31,2011,1,Philippines,Asia South East,0,0,0,1,1
2011-03-31,2011,1,Poland,EU 8,0,0,0,1,1
2011-03-31,2011,1,Saudi Arabia,Middle East,0,0,0,1,1
2011-03-31,2011,1,Senegal,Africa Sub-Saharan,0,0,0,1,1
2011-03-31,2011,1,Serbia and Montenegro,Europe Other,2,1,1,0,1
2011-03-31,2011,1,Sierra Leone,Africa Sub-Saharan,10,8,0,0,0
2011-03-31,2011,1,South Africa,Africa Sub-Saharan,26,24,7,0,7
2011-03-31,2011,1,South Korea,Asia East,2,2,2,0,2
2011-03-31,2011,1,Sri Lanka,Asia South,0,0,0,4,4
2011-03-31,2011,1,Thailand,Asia South East,0,0,0,1,1
2011-03-31,2011,1,Turkey,Europe Other,0,0,0,3,3
2011-03-31,2011,1,Ukraine,Europe Other,9,9,5,0,5
2011-03-31,2011,1,United States,America North,0,0,0,1,1
2011-03-31,2011,1,Uzbekistan,Asia Central,0,0,0,1,1
2011-03-31,2011,1,Vietnam,Asia South East,0,0,0,2,2
2011-03-31,2011,1,Western Sahara,Africa North,0,0,0,1,1
2011-06-30,2011,2,Afghanistan,Asia Central,0,0,0,1,1
2011-06-30,2011,2,Albania,Europe Other,45,33,11,0,11
2011-06-30,2011,2,Algeria,Africa North,0,0,0,8,8
2011-06-30,2011,2,Australia,Oceania,0,0,0,1,1
2011-06-30,2011,2,Bangladesh,Asia South,0,0,0,12,12
2011-06-30,2011,2,Bolivia,America Central and South,9,8,6,0,6
2011-06-30,2011,2,Bosnia and Herzegovina,Europe Other,1,1,0,0,0
2011-06-30,2011,2,Brazil,America Central and South,5,5,2,0,2
2011-06-30,2011,2,Bulgaria,EU 2,0,0,0,1,1
2011-06-30,2011,2,Canada,America North,0,0,0,1,1
2011-06-30,2011,2,China,Asia East,0,0,0,6,6
2011-06-30,2011,2,Colombia,America Central and South,0,0,0,1,1
2011-06-30,2011,2,Congo (Democratic Republic),Africa Sub-Saharan,0,0,0,1,1
2011-06-30,2011,2,Egypt,Africa North,0,0,0,2,2
2011-06-30,2011,2,Ethiopia,Africa Sub-Saharan,0,0,0,1,1
2011-06-30,2011,2,"Gambia, The",Africa Sub-Saharan,26,17,5,2,7
2011-06-30,2011,2,Ghana,Africa Sub-Saharan,14,13,7,2,9
2011-06-30,2011,2,Honduras,America Central and South,0,0,0,2,2
2011-06-30,2011,2,India,Asia South,86,83,51,0,51
2011-06-30,2011,2,Iraq,Middle East,0,0,0,1,1
2011-06-30,2011,2,Ivory Coast,Africa Sub-Saharan,0,0,0,2,2
2011-06-30,2011,2,Jamaica,America Central and South,31,22,8,0,8
2011-06-30,2011,2,Japan,Asia East,0,0,0,2,2
2011-06-30,2011,2,Kenya,Africa Sub-Saharan,7,4,2,0,2
2011-06-30,2011,2,Korea (North),Asia East,0,0,0,1,1
2011-06-30,2011,2,Kosovo,Europe Other,3,3,2,0,2
2011-06-30,2011,2,Malawi,Africa Sub-Saharan,12,9,3,0,3
2011-06-30,2011,2,Malaysia,Asia South East,0,0,0,1,1
2011-06-30,2011,2,Mali,Africa Sub-Saharan,2,1,0,0,0
2011-06-30,2011,2,Mauritius,Africa Sub-Saharan,8,8,2,0,2
2011-06-30,2011,2,Moldova,Europe Other,2,2,0,0,0
2011-06-30,2011,2,Mongolia,Asia East,8,4,1,0,1
2011-06-30,2011,2,Morocco,Africa North,0,0,0,1,1
2011-06-30,2011,2,Nepal,Asia South,0,0,0,1,1
2011-06-30,2011,2,Nigeria,Africa Sub-Saharan,77,71,26,10,36
2011-06-30,2011,2,North Macedonia,Europe Other,1,1,0,0,0
2011-06-30,2011,2,Pakistan,Asia South,0,0,0,27,27
2011-06-30,2011,2,Senegal,Africa Sub-Saharan,0,0,0,2,2
2011-06-30,2011,2,Sierra Leone,Africa Sub-Saharan,6,4,0,0,0
2011-06-30,2011,2,South Africa,Africa Sub-Saharan,12,11,4,0,4
2011-06-30,2011,2,South Korea,Asia East,1,0,0,0,0
2011-06-30,2011,2,Sri Lanka,Asia South,0,0,0,1,1
2011-06-30,2011,2,St Lucia,America Central and South,0,0,0,1,1
2011-06-30,2011,2,Tanzania,Africa Sub-Saharan,0,0,0,2,2
2011-06-30,2011,2,Togo,Africa Sub-Saharan,0,0,0,1,1
2011-06-30,2011,2,Turkey,Europe Other,0,0,0,1,1
2011-06-30,2011,2,Ukraine,Europe Other,2,2,0,0,0
2011-06-30,2011,2,United States,America North,0,0,0,2,2
2011-06-30,2011,2,Vietnam,Asia South East,0,0,0,1,1
2011-06-30,2011,2,Zimbabwe,Africa Sub-Saharan,0,0,0,1,1
2011-09-30,2011,3,Afghanistan,Asia Central,0,0,0,1,1
2011-09-30,2011,3,Albania,Europe Other,52,30,9,0,9
2011-09-30,2011,3,Algeria,Africa North,0,0,0,8,8
2011-09-30,2011,3,Bangladesh,Asia South,0,0,0,29,29
2011-09-30,2011,3,Bolivia,America Central and South,5,5,4,0,4
2011-09-30,2011,3,Bosnia and Herzegovina,Europe Other,1,1,0,0,0
2011-09-30,2011,3,Brazil,America Central and South,5,5,3,0,3
2011-09-30,2011,3,Chile,America Central and South,0,0,0,1,1
2011-09-30,2011,3,China,Asia East,0,0,0,3,3
2011-09-30,2011,3,Colombia,America Central and South,0,0,0,1,1
2011-09-30,2011,3,Ecuador,America Central and South,1,1,0,0,0
2011-09-30,2011,3,Egypt,Africa North,0,0,0,1,1
2011-09-30,2011,3,"Gambia, The",Africa Sub-Saharan,20,16,1,0,1
2011-09-30,2011,3,Ghana,Africa Sub-Saharan,16,14,8,2,10
2011-09-30,2011,3,India,Asia South,66,64,46,0,46
2011-09-30,2011,3,Iran,Middle East,0,0,0,1,1
2011-09-30,2011,3,Iraq,Middle East,0,0,0,1,1
2011-09-30,2011,3,Israel,Middle East,0,0,0,1,1
2011-09-30,2011,3,Jamaica,America Central and South,40,30,7,0,7
2011-09-30,2011,3,Kenya,Africa Sub-Saharan,8,7,0,0,0
2011-09-30,2011,3,Kosovo,Europe Other,1,1,0,0,0
2011-09-30,2011,3,Liberia,Africa Sub-Saharan,1,1,1,0,1
2011-09-30,2011,3,Malawi,Africa Sub-Saharan,10,9,3,2,5
2011-09-30,2011,3,Malaysia,Asia South East,0,0,0,3,3
2011-09-30,2011,3,Mauritius,Africa Sub-Saharan,7,7,3,0,3
2011-09-30,2011,3,Moldova,Europe Other,1,0,0,0,0
2011-09-30,2011,3,Mongolia,Asia East,9,7,1,0,1
2011-09-30,2011,3,Mozambique,Africa Sub-Saharan,0,0,0,1,1
2011-09-30,2011,3,Nepal,Asia South,0,0,0,2,2
2011-09-30,2011,3,Nigeria,Africa Sub-Saharan,85,74,31,10,41
2011-09-30,2011,3,Occupied Palestinian Territories,Middle East,0,0,0,2,2
2011-09-30,2011,3,Pakistan,Asia South,0,0,0,51,51
2011-09-30,2011,3,Poland,EU 8,0,0,0,1,1
2011-09-30,2011,3,Russia,Europe Other,0,0,0,1,1
2011-09-30,2011,3,Serbia and Montenegro,Europe Other,1,1,0,0,0
2011-09-30,2011,3,Sierra Leone,Africa Sub-Saharan,6,6,1,0,1
2011-09-30,2011,3,South Africa,Africa Sub-Saharan,15,13,5,0,5
2011-09-30,2011,3,South Korea,Asia East,1,1,0,0,0
2011-09-30,2011,3,Sri Lanka,Asia South,0,0,0,5,5
2011-09-30,2011,3,Tunisia,Africa North,0,0,0,1,1
2011-09-30,2011,3,Ukraine,Europe Other,5,5,2,0,2
2011-09-30,2011,3,Uzbekistan,Asia Central,0,0,0,1,1
2011-09-30,2011,3,Vietnam,Asia South East,0,0,0,2,2
2011-12-31,2011,4,Afghanistan,Asia Central,0,0,0,1,1
2011-12-31,2011,4,Albania,Europe Other,72,48,8,0,8
2011-12-31,2011,4,Algeria,Africa North,0,0,0,10,10
2011-12-31,2011,4,Australia,Oceania,0,0,0,1,1
2011-12-31,2011,4,Bangladesh,Asia South,0,0,0,24,24
2011-12-31,2011,4,Bolivia,America Central and South,4,4,3,0,3
2011-12-31,2011,4,Brazil,America Central and South,4,4,4,0,4
2011-12-31,2011,4,Cameroon,Africa Sub-Saharan,0,0,0,1,1
2011-12-31,2011,4,China,Asia East,0,0,0,7,7
2011-12-31,2011,4,Ecuador,America Central and South,2,1,1,0,1
2011-12-31,2011,4,El Salvador,America Central and South,0,0,0,1,1
2011-12-31,2011,4,"Gambia, The",Africa Sub-Saharan,15,14,2,1,3
2011-12-31,2011,4,Georgia,Europe Other,0,0,0,1,1
2011-12-31,2011,4,Germany,EU 14,0,0,0,1,1
2011-12-31,2011,4,Ghana,Africa Sub-Saharan,13,11,5,1,6
2011-12-31,2011,4,India,Asia South,92,85,63,0,63
2011-12-31,2011,4,Iraq,Middle East,0,0,0,2,2
2011-12-31,2011,4,Ivory Coast,Africa Sub-Saharan,0,0,0,1,1
2011-12-31,2011,4,Jamaica,America Central and South,32,22,3,0,3
2011-12-31,2011,4,Kenya,Africa Sub-Saharan,2,1,0,2,2
2011-12-31,2011,4,Korea (North),Asia East,0,0,0,1,1
2011-12-31,2011,4,Kosovo,Europe Other,5,2,0,0,0
2011-12-31,2011,4,Liberia,Africa Sub-Saharan,2,2,1,0,1
2011-12-31,2011,4,Malawi,Africa Sub-Saharan,12,10,1,1,2
2011-12-31,2011,4,Malaysia,Asia South East,0,0,0,2,2
2011-12-31,2011,4,Mali,Africa Sub-Saharan,1,1,0,0,0
2011-12-31,2011,4,Mauritius,Africa Sub-Saharan,3,3,2,0,2
2011-12-31,2011,4,Mexico,America Central and South,0,0,0,1,1
2011-12-31,2011,4,Moldova,Europe Other,3,1,1,0,1
2011-12-31,2011,4,Mongolia,Asia East,8,6,2,0,2
2011-12-31,2011,4,Nigeria,Africa Sub-Saharan,59,55,19,6,25
2011-12-31,2011,4,North Macedonia,Europe Other,1,0,0,0,0
2011-12-31,2011,4,Pakistan,Asia South,0,0,0,52,52
2011-12-31,2011,4,Poland,EU 8,0,0,0,1,1
2011-12-31,2011,4,Russia,Europe Other,0,0,0,1,1
2011-12-31,2011,4,Serbia and Montenegro,Europe Other,1,1,0,0,0
2011-12-31,2011,4,Sierra Leone,Africa Sub-Saharan,2,2,1,0,1
2011-12-31,2011,4,South Africa,Africa Sub-Saharan,12,11,5,0,5
2011-12-31,2011,4,Spain,EU 14,0,0,0,1,1
2011-12-31,2011,4,Sri Lanka,Asia South,0,0,0,1,1
2011-12-31,2011,4,Taiwan,Asia East,0,0,0,1,1
2011-12-31,2011,4,Turkey,Europe Other,0,0,0,1,1
2011-12-31,2011,4,Ukraine,Europe Other,7,6,3,0,3
2011-12-31,2011,4,Vietnam,Asia South East,0,0,0,5,5
2011-12-31,2011,4,Zambia,Africa Sub-Saharan,0,0,0,1,1
2011-12-31,2011,4,Zimbabwe,Africa Sub-Saharan,0,0,0,2,2
2012-03-31,2012,1,Afghanistan,Asia Central,0,0,0,2,2
2012-03-31,2012,1,Albania,Europe Other,98,55,9,0,9
2012-03-31,2012,1,Algeria,Africa North,0,0,0,9,9
2012-03-31,2012,1,Bangladesh,Asia South,0,0,0,39,39
2012-03-31,2012,1,Bolivia,America Central and South,3,3,0,0,0
2012-03-31,2012,1,Bosnia and Herzegovina,Europe Other,1,1,0,0,0
2012-03-31,2012,1,Botswana,Africa Sub-Saharan,0,0,0,1,1
2012-03-31,2012,1,Brazil,America Central and South,4,4,2,0,2
2012-03-31,2012,1,Cameroon,Africa Sub-Saharan,0,0,0,1,1
2012-03-31,2012,1,Canada,America North,0,0,0,1,1
2012-03-31,2012,1,China,Asia East,0,0,0,11,11
2012-03-31,2012,1,Colombia,America Central and South,0,0,0,1,1
2012-03-31,2012,1,Croatia,EU Other,0,0,0,1,1
2012-03-31,2012,1,"Gambia, The",Africa Sub-Saharan,19,17,3,1,4
2012-03-31,2012,1,Ghana,Africa Sub-Saharan,32,27,14,2,16
2012-03-31,2012,1,India,Asia South,82,80,54,1,55
2012-03-31,2012,1,Iraq,Middle East,0,0,0,1,1
2012-03-31,2012,1,Jamaica,America Central and South,34,31,5,0,5
2012-03-31,2012,1,Jordan,Middle East,0,0,0,1,1
2012-03-31,2012,1,Kenya,Africa Sub-Saharan,7,6,2,1,3
2012-03-31,2012,1,Kosovo,Europe Other,2,2,1,0,1
2012-03-31,2012,1,Liberia,Africa Sub-Saharan,1,1,0,0,0
2012-03-31,2012,1,Libya,Africa North,0,0,0,2,2
2012-03-31,2012,1,Malawi,Africa Sub-Saharan,12,11,4,1,5
2012-03-31,2012,1,Malaysia,Asia South East,0,0,0,1,1
2012-03-31,2012,1,Mali,Africa Sub-Saharan,3,3,0,0,0
2012-03-31,2012,1,Mauritius,Africa Sub-Saharan,10,8,4,0,4
2012-03-31,2012,1,Moldova,Europe Other,1,0,0,0,0
2012-03-31,2012,1,Mongolia,Asia East,1,1,1,0,1
2012-03-31,2012,1,Morocco,Africa North,0,0,0,2,2
2012-03-31,2012,1,Nigeria,Africa Sub-Saharan,82,73,32,4,36
2012-03-31,2012,1,Pakistan,Asia South,0,0,0,71,71
2012-03-31,2012,1,Poland,EU 8,0,0,0,1,1
2012-03-31,2012,1,Senegal,Africa Sub-Saharan,0,0,0,3,3
2012-03-31,2012,1,Serbia and Montenegro,Europe Other,1,1,0,0,0
2012-03-31,2012,1,Sierra Leone,Africa Sub-Saharan,4,4,2,1,3
2012-03-31,2012,1,Somalia,Africa Sub-Saharan,0,0,0,1,1
2012-03-31,2012,1,South Africa,Africa Sub-Saharan,7,5,1,0,1
2012-03-31,2012,1,Sri Lanka,Asia South,0,0,0,2,2
2012-03-31,2012,1,St Lucia,America Central and South,0,0,0,1,1
2012-03-31,2012,1,Trinidad and Tobago,America Central and South,0,0,0,1,1
2012-03-31,2012,1,Tunisia,Africa North,0,0,0,1,1
2012-03-31,2012,1,Turkey,Europe Other,0,0,0,1,1
2012-03-31,2012,1,Uganda,Africa Sub-Saharan,0,0,0,1,1
2012-03-31,2012,1,Ukraine,Europe Other,10,7,3,0,3
2012-03-31,2012,1,United States,America North,0,0,0,1,1
2012-03-31,2012,1,Vietnam,Asia South East,0,0,0,3,3
2012-03-31,2012,1,Yemen,Middle East,0,0,0,1,1
2012-03-31,2012,1,Zimbabwe,Africa Sub-Saharan,0,0,0,1,1
2012-06-30,2012,2,Afghanistan,Asia Central,0,0,0,1,1
2012-06-30,2012,2,Albania,Europe Other,118,73,18,0,18
2012-06-30,2012,2,Algeria,Africa North,0,0,0,11,11
2012-06-30,2012,2,Argentina,America Central and South,0,0,0,1,1
2012-06-30,2012,2,"Bahamas, The",America Central and South,0,0,0,1,1
2012-06-30,2012,2,Bangladesh,Asia South,0,0,0,65,65
2012-06-30,2012,2,Bosnia and Herzegovina,Europe Other,1,0,0,0,0
2012-06-30,2012,2,Cameroon,Africa Sub-Saharan,0,0,0,1,1
2012-06-30,2012,2,Canada,America North,0,0,0,1,1
2012-06-30,2012,2,China,Asia East,0,0,0,16,16
2012-06-30,2012,2,Colombia,America Central and South,0,0,0,2,2
2012-06-30,2012,2,Egypt,Africa North,0,0,0,2,2
2012-06-30,2012,2,"Gambia, The",Africa Sub-Saharan,28,17,3,1,4
2012-06-30,2012,2,Ghana,Africa Sub-Saharan,20,19,12,0,12
2012-06-30,2012,2,Hong Kong,Asia East,0,0,0,1,1
2012-06-30,2012,2,India,Asia South,128,126,100,0,100
2012-06-30,2012,2,Iran,Middle East,0,0,0,1,1
2012-06-30,2012,2,Jamaica,America Central and South,32,24,6,0,6
2012-06-30,2012,2,Kenya,Africa Sub-Saharan,5,4,0,0,0
2012-06-30,2012,2,Kosovo,Europe Other,6,5,3,0,3
2012-06-30,2012,2,Lebanon,Middle East,0,0,0,1,1
2012-06-30,2012,2,Lithuania,EU 8,0,0,0,1,1
2012-06-30,2012,2,Malawi,Africa Sub-Saharan,6,4,2,2,4
2012-06-30,2012,2,Mauritius,Africa Sub-Saharan,9,9,3,0,3
2012-06-30,2012,2,Moldova,Europe Other,3,3,2,0,2
2012-06-30,2012,2,Mongolia,Asia East,4,4,1,0,1
2012-06-30,2012,2,Morocco,Africa North,0,0,0,5,5
2012-06-30,2012,2,Namibia,Africa Sub-Saharan,0,0,0,1,1
2012-06-30,2012,2,Nigeria,Africa Sub-Saharan,103,91,41,6,47
2012-06-30,2012,2,Pakistan,Asia South,0,0,0,72,72
2012-06-30,2012,2,Russia,Europe Other,0,0,0,1,1
2012-06-30,2012,2,Serbia and Montenegro,Europe Other,1,1,0,0,0
2012-06-30,2012,2,Sierra Leone,Africa Sub-Saharan,5,5,2,1,3
2012-06-30,2012,2,Slovakia,EU 8,0,0,0,1,1
2012-06-30,2012,2,Somalia,Africa Sub-Saharan,0,0,0,1,1
2012-06-30,2012,2,South Africa,Africa Sub-Saharan,17,17,9,0,9
2012-06-30,2012,2,Sri Lanka,Asia South,0,0,0,2,2
2012-06-30,2012,2,Taiwan,Asia East,0,0,0,1,1
2012-06-30,2012,2,Tanzania,Africa Sub-Saharan,0,0,0,1,1
2012-06-30,2012,2,Turkey,Europe Other,0,0,0,1,1
2012-06-30,2012,2,Ukraine,Europe Other,5,4,0,0,0
2012-06-30,2012,2,United States,America North,0,0,0,1,1
2012-06-30,2012,2,Vietnam,Asia South East,0,0,0,4,4
2012-06-30,2012,2,Zambia,Africa Sub-Saharan,0,0,0,1,1
2012-06-30,2012,2,Zimbabwe,Africa Sub-Saharan,0,0,0,1,1
2012-09-30,2012,3,Afghanistan,Asia Central,0,0,0,3,3
2012-09-30,2012,3,Albania,Europe Other,119,71,21,0,21
2012-09-30,2012,3,Algeria,Africa North,0,0,0,4,4
2012-09-30,2012,3,Argentina,America Central and South,0,0,0,1,1
2012-09-30,2012,3,Australia,Oceania,0,0,0,1,1
2012-09-30,2012,3,Bangladesh,Asia South,0,0,0,42,42
2012-09-30,2012,3,Bosnia and Herzegovina,Europe Other,2,2,1,0,1
2012-09-30,2012,3,Botswana,Africa Sub-Saharan,0,0,0,1,1
2012-09-30,2012,3,Brazil,America Central and South,1,1,1,0,1
2012-09-30,2012,3,China,Asia East,0,0,0,4,4
2012-09-30,2012,3,"Gambia, The",Africa Sub-Saharan,26,17,3,0,3
2012-09-30,2012,3,Ghana,Africa Sub-Saharan,17,16,11,1,12
2012-09-30,2012,3,Guyana,America Central and South,0,0,0,1,1
2012-09-30,2012,3,India,Asia South,130,130,106,0,106
2012-09-30,2012,3,Iran,Middle East,0,0,0,1,1
2012-09-30,2012,3,Israel,Middle East,0,0,0,1,1
2012-09-30,2012,3,Jamaica,America Central and South,22,14,4,0,4
2012-09-30,2012,3,Kenya,Africa Sub-Saharan,6,6,2,0,2
2012-09-30,2012,3,Korea (North),Asia East,0,0,0,1,1
2012-09-30,2012,3,Malawi,Africa Sub-Saharan,11,9,2,0,2
2012-09-30,2012,3,Mali,Africa Sub-Saharan,3,3,3,0,3
2012-09-30,2012,3,Mauritius,Africa Sub-Saharan,5,5,5,0,5
2012-09-30,2012,3,Mongolia,Asia East,6,5,1,0,1
2012-09-30,2012,3,Morocco,Africa North,0,0,0,2,2
2012-09-30,2012,3,Namibia,Africa Sub-Saharan,0,0,0,2,2
2012-09-30,2012,3,Nepal,Asia South,0,0,0,1,1
2012-09-30,2012,3,Nigeria,Africa Sub-Saharan,96,86,36,18,54
2012-09-30,2012,3,Pakistan,Asia South,0,0,0,63,63
2012-09-30,2012,3,Philippines,Asia South East,0,0,0,2,2
2012-09-30,2012,3,Poland,EU 8,0,0,0,1,1
2012-09-30,2012,3,Sierra Leone,Africa Sub-Saharan,11,9,4,0,4
2012-09-30,2012,3,South Africa,Africa Sub-Saharan,5,4,4,0,4
2012-09-30,2012,3,South Korea,Asia East,2,2,1,0,1
2012-09-30,2012,3,Sri Lanka,Asia South,0,0,0,2,2
2012-09-30,2012,3,Syria,Middle East,0,0,0,1,1
2012-09-30,2012,3,Tanzania,Africa Sub-Saharan,0,0,0,1,1
2012-09-30,2012,3,Turkey,Europe Other,0,0,0,2,2
2012-09-30,2012,3,Ukraine,Europe Other,4,4,1,0,1
2012-09-30,2012,3,United States,America North,0,0,0,1,1
2012-09-30,2012,3,Vietnam,Asia South East,0,0,0,3,3
2012-12-31,2012,4,Albania,Europe Other,108,83,30,0,30
2012-12-31,2012,4,Algeria,Africa North,0,0,0,3,3
2012-12-31,2012,4,Bangladesh,Asia South,0,0,0,32,32
2012-12-31,2012,4,Bolivia,America Central and South,2,2,1,0,1
2012-12-31,2012,4,Brazil,America Central and South,3,3,2,0,2
2012-12-31,2012,4,Canada,America North,0,0,0,2,2
2012-12-31,2012,4,China,Asia East,0,0,0,5,5
2012-12-31,2012,4,Egypt,Africa North,0,0,0,1,1
2012-12-31,2012,4,"Gambia, The",Africa Sub-Saharan,26,17,2,1,3
2012-12-31,2012,4,Georgia,Europe Other,0,0,0,1,1
2012-12-31,2012,4,Ghana,Africa Sub-Saharan,16,14,5,0,5
2012-12-31,2012,4,India,Asia South,162,159,119,0,119
2012-12-31,2012,4,Jamaica,America Central and South,16,13,0,0,0
2012-12-31,2012,4,Kenya,Africa Sub-Saharan,5,5,1,1,2
2012-12-31,2012,4,Korea (North),Asia East,0,0,0,3,3
2012-12-31,2012,4,Kosovo,Europe Other,1,1,1,0,1
2012-12-31,2012,4,Latvia,EU 8,0,0,0,1,1
2012-12-31,2012,4,Libya,Africa North,0,0,0,1,1
2012-12-31,2012,4,Lithuania,EU 8,0,0,0,1,1
2012-12-31,2012,4,Malawi,Africa Sub-Saharan,5,5,2,0,2
2012-12-31,2012,4,Mauritius,Africa Sub-Saharan,5,5,2,0,2
2012-12-31,2012,4,Mongolia,Asia East,1,1,0,0,0
2012-12-31,2012,4,Nepal,Asia South,0,0,0,1,1
2012-12-31,2012,4,Nigeria,Africa Sub-Saharan,108,99,48,14,62
2012-12-31,2012,4,North Macedonia,Europe Other,2,1,0,0,0
2012-12-31,2012,4,Pakistan,Asia South,0,0,0,72,72
2012-12-31,2012,4,Poland,EU 8,0,0,0,11,11
2012-12-31,2012,4,Romania,EU 2,0,0,0,1,1
2012-12-31,2012,4,Sierra Leone,Africa Sub-Saharan,6,5,1,0,1
2012-12-31,2012,4,Slovakia,EU 8,0,0,0,1,1
2012-12-31,2012,4,South Africa,Africa Sub-Saharan,10,8,5,0,5
2012-12-31,2012,4,South Korea,Asia East,2,2,1,0,1
2012-12-31,2012,4,Sri Lanka,Asia South,0,0,0,2,2
2012-12-31,2012,4,Tanzania,Africa Sub-Saharan,0,0,0,1,1
2012-12-31,2012,4,Uganda,Africa Sub-Saharan,0,0,0,1,1
2012-12-31,2012,4,Ukraine,Europe Other,7,5,1,0,1
2012-12-31,2012,4,Vietnam,Asia South East,0,0,0,1,1
2012-12-31,2012,4,Zambia,Africa Sub-Saharan,0,0,0,1,1
2013-03-31,2013,1,Albania,Europe Other,218,134,20,0,20
2013-03-31,2013,1,Algeria,Africa North,0,0,0,3,3
2013-03-31,2013,1,Bangladesh,Asia South,0,0,0,22,22
2013-03-31,2013,1,Bolivia,America Central and South,1,0,0,0,0
2013-03-31,2013,1,Brazil,America Central and South,6,2,1,0,1
2013-03-31,2013,1,Burundi,Africa Sub-Saharan,0,0,0,1,1
2013-03-31,2013,1,Canada,America North,0,0,0,3,3
2013-03-31,2013,1,China,Asia East,0,0,0,2,2
2013-03-31,2013,1,Congo,Africa Sub-Saharan,0,0,0,1,1
2013-03-31,2013,1,Egypt,Africa North,0,0,0,1,1
2013-03-31,2013,1,Estonia,EU 8,0,0,0,1,1
2013-03-31,2013,1,"Gambia, The",Africa Sub-Saharan,31,24,4,0,4
2013-03-31,2013,1,Ghana,Africa Sub-Saharan,20,17,8,1,9
2013-03-31,2013,1,Hungary,EU 8,0,0,0,2,2
2013-03-31,2013,1,India,Asia South,163,159,123,0,123
2013-03-31,2013,1,Iran,Middle East,0,0,0,1,1
2013-03-31,2013,1,Italy,EU 14,0,0,0,1,1
2013-03-31,2013,1,Jamaica,America Central and South,28,23,2,0,2
2013-03-31,2013,1,Japan,Asia East,0,0,0,1,1
2013-03-31,2013,1,Kenya,Africa Sub-Saharan,8,8,4,0,4
2013-03-31,2013,1,Kosovo,Europe Other,5,4,0,0,0
2013-03-31,2013,1,Latvia,EU 8,0,0,0,1,1
2013-03-31,2013,1,Lithuania,EU 8,0,0,0,3,3
2013-03-31,2013,1,Malawi,Africa Sub-Saharan,9,7,3,1,4
2013-03-31,2013,1,Mali,Africa Sub-Saharan,7,7,2,0,2
2013-03-31,2013,1,Mauritius,Africa Sub-Saharan,5,5,3,0,3
2013-03-31,2013,1,Moldova,Europe Other,1,1,0,0,0
2013-03-31,2013,1,Mongolia,Asia East,3,3,0,0,0
2013-03-31,2013,1,Morocco,Africa North,0,0,0,3,3
2013-03-31,2013,1,Namibia,Africa Sub-Saharan,0,0,0,2,2
2013-03-31,2013,1,Nepal,Asia South,0,0,0,1,1
2013-03-31,2013,1,Nigeria,Africa Sub-Saharan,114,103,48,11,59
2013-03-31,2013,1,North Macedonia,Europe Other,1,0,0,0,0
2013-03-31,2013,1,Pakistan,Asia South,0,0,0,38,38
2013-03-31,2013,1,Peru,America Central and South,1,1,1,0,1
2013-03-31,2013,1,Poland,EU 8,0,0,0,26,26
2013-03-31,2013,1,Refugee,Other,0,0,0,1,1
2013-03-31,2013,1,Russia,Europe Other,0,0,0,1,1
2013-03-31,2013,1,Senegal,Africa Sub-Saharan,0,0,0,1,1
2013-03-31,2013,1,Seychelles,Africa Sub-Saharan,0,0,0,1,1
2013-03-31,2013,1,Sierra Leone,Africa Sub-Saharan,7,5,0,1,1
2013-03-31,2013,1,South Africa,Africa Sub-Saharan,8,7,3,0,3
2013-03-31,2013,1,South Korea,Asia East,2,2,2,0,2
2013-03-31,2013,1,Sri Lanka,Asia South,0,0,0,2,2
2013-03-31,2013,1,Tanzania,Africa Sub-Saharan,0,0,0,1,1
2013-03-31,2013,1,Turkey,Europe Other,0,0,0,1,1
2013-03-31,2013,1,Uganda,Africa Sub-Saharan,0,0,0,1,1
2013-03-31,2013,1,Ukraine,Europe Other,6,5,3,0,3
2013-03-31,2013,1,United States,America North,0,0,0,2,2
2013-03-31,2013,1,Vietnam,Asia South East,0,0,0,2,2
2013-06-30,2013,2,Albania,Europe Other,246,164,36,0,36
2013-06-30,2013,2,Algeria,Africa North,0,0,0,2,2
2013-06-30,2013,2,Bangladesh,Asia South,0,0,0,13,13
2013-06-30,2013,2,Brazil,America Central and South,3,3,3,0,3
2013-06-30,2013,2,Cameroon,Africa Sub-Saharan,0,0,0,1,1
2013-06-30,2013,2,Canada,America North,0,0,0,1,1
2013-06-30,2013,2,China,Asia East,0,0,0,9,9
2013-06-30,2013,2,Czech Republic,EU 8,0,0,0,2,2
2013-06-30,2013,2,Ecuador,America Central and South,3,3,1,0,1
2013-06-30,2013,2,Egypt,Africa North,0,0,0,1,1
2013-06-30,2013,2,"Gambia, The",Africa Sub-Saharan,28,20,4,0,4
2013-06-30,2013,2,Ghana,Africa Sub-Saharan,40,36,15,1,16
2013-06-30,2013,2,India,Asia South,187,185,139,0,139
2013-06-30,2013,2,Iran,Middle East,0,0,0,2,2
2013-06-30,2013,2,Iraq,Middle East,0,0,0,1,1
2013-06-30,2013,2,Jamaica,America Central and South,36,32,4,0,4
2013-06-30,2013,2,Kenya,Africa Sub-Saharan,9,9,1,0,1
2013-06-30,2013,2,Korea (North),Asia East,0,0,0,2,2
2013-06-30,2013,2,Kosovo,Europe Other,3,3,1,0,1
2013-06-30,2013,2,Latvia,EU 8,0,0,0,3,3
2013-06-30,2013,2,Libya,Africa North,0,0,0,1,1
2013-06-30,2013,2,Lithuania,EU 8,0,0,0,3,3
2013-06-30,2013,2,Malawi,Africa Sub-Saharan,12,7,1,0,1
2013-06-30,2013,2,Mali,Africa Sub-Saharan,3,3,1,0,1
2013-06-30,2013,2,Mauritius,Africa Sub-Saharan,9,6,1,0,1
2013-06-30,2013,2,Mongolia,Asia East,5,5,2,0,2
2013-06-30,2013,2,Nepal,Asia South,0,0,0,1,1
2013-06-30,2013,2,Netherlands,EU 14,0,0,0,1,1
2013-06-30,2013,2,Nigeria,Africa Sub-Saharan,126,111,53,13,66
2013-06-30,2013,2,Pakistan,Asia South,0,0,0,44,44
2013-06-30,2013,2,Philippines,Asia South East,0,0,0,3,3
2013-06-30,2013,2,Poland,EU 8,0,0,0,15,15
2013-06-30,2013,2,Romania,EU 2,0,0,0,1,1
2013-06-30,2013,2,Sierra Leone,Africa Sub-Saharan,8,7,2,0,2
2013-06-30,2013,2,South Africa,Africa Sub-Saharan,14,11,4,0,4
2013-06-30,2013,2,Sri Lanka,Asia South,0,0,0,2,2
2013-06-30,2013,2,Thailand,Asia South East,0,0,0,1,1
2013-06-30,2013,2,Tunisia,Africa North,0,0,0,1,1
2013-06-30,2013,2,Turkey,Europe Other,0,0,0,1,1
2013-06-30,2013,2,Ukraine,Europe Other,3,2,0,0,0
2013-06-30,2013,2,United States,America North,0,0,0,2,2
2013-06-30,2013,2,Vietnam,Asia South East,0,0,0,5,5
2013-09-30,2013,3,Afghanistan,Asia Central,0,0,0,1,1
2013-09-30,2013,3,Albania,Europe Other,172,105,27,0,27
2013-09-30,2013,3,Bangladesh,Asia South,0,0,0,16,16
2013-09-30,2013,3,Cameroon,Africa Sub-Saharan,0,0,0,1,1
2013-09-30,2013,3,China,Asia East,0,0,0,5,5
2013-09-30,2013,3,Czech Republic,EU 8,0,0,0,2,2
2013-09-30,2013,3,Egypt,Africa North,0,0,0,1,1
2013-09-30,2013,3,El Salvador,America Central and South,0,0,0,1,1
2013-09-30,2013,3,France,EU 14,0,0,0,1,1
2013-09-30,2013,3,"Gambia, The",Africa Sub-Saharan,17,12,0,0,0
2013-09-30,2013,3,Georgia,Europe Other,0,0,0,2,2
2013-09-30,2013,3,Ghana,Africa Sub-Saharan,25,22,9,0,9
2013-09-30,2013,3,Hungary,EU 8,0,0,0,1,1
2013-09-30,2013,3,India,Asia South,128,125,91,0,91
2013-09-30,2013,3,Iran,Middle East,0,0,0,1,1
2013-09-30,2013,3,Iraq,Middle East,0,0,0,2,2
2013-09-30,2013,3,Italy,EU 14,0,0,0,1,1
2013-09-30,2013,3,Jamaica,America Central and South,30,27,9,0,9
2013-09-30,2013,3,Japan,Asia East,0,0,0,1,1
2013-09-30,2013,3,Kenya,Africa Sub-Saharan,6,4,1,1,2
2013-09-30,2013,3,Kosovo,Europe Other,2,2,0,0,0
2013-09-30,2013,3,Latvia,EU 8,0,0,0,2,2
2013-09-30,2013,3,Lithuania,EU 8,0,0,0,5,5
2013-09-30,2013,3,Malawi,Africa Sub-Saharan,9,9,2,2,4
2013-09-30,2013,3,Mali,Africa Sub-Saharan,3,3,0,0,0
2013-09-30,2013,3,Mauritius,Africa Sub-Saharan,5,3,2,0,2
2013-09-30,2013,3,Mongolia,Asia East,4,1,1,0,1
2013-09-30,2013,3,Namibia,Africa Sub-Saharan,0,0,0,1,1
2013-09-30,2013,3,Nigeria,Africa Sub-Saharan,108,99,43,11,54
2013-09-30,2013,3,Pakistan,Asia South,0,0,0,30,30
2013-09-30,2013,3,Philippines,Asia South East,0,0,0,4,4
2013-09-30,2013,3,Poland,EU 8,0,0,0,24,24
2013-09-30,2013,3,Romania,EU 2,0,0,0,1,1
2013-09-30,2013,3,Sierra Leone,Africa Sub-Saharan,6,5,0,0,0
2013-09-30,2013,3,Slovakia,EU 8,0,0,0,1,1
2013-09-30,2013,3,South Africa,Africa Sub-Saharan,13,10,4,0,4
2013-09-30,2013,3,Sri Lanka,Asia South,0,0,0,4,4
2013-09-30,2013,3,Syria,Middle East,0,0,0,1,1
2013-09-30,2013,3,Tanzania,Africa Sub-Saharan,0,0,0,1,1
2013-09-30,2013,3,Turkey,Europe Other,0,0,0,1,1
2013-09-30,2013,3,Uganda,Africa Sub-Saharan,0,0,0,1,1
2013-09-30,2013,3,Ukraine,Europe Other,4,3,3,0,3
2013-09-30,2013,3,Vietnam,Asia South East,0,0,0,4,4
2013-09-30,2013,3,Zimbabwe,Africa Sub-Saharan,0,0,0,3,3
2013-12-31,2013,4,Albania,Europe Other,142,92,21,0,21
2013-12-31,2013,4,Algeria,Africa North,0,0,0,1,1
2013-12-31,2013,4,Australia,Oceania,0,0,0,1,1
2013-12-31,2013,4,Bangladesh,Asia South,0,0,0,3,3
2013-12-31,2013,4,Bolivia,America Central and South,2,2,2,0,2
2013-12-31,2013,4,Brazil,America Central and South,3,3,2,0,2
2013-12-31,2013,4,China,Asia East,0,0,0,2,2
2013-12-31,2013,4,Colombia,America Central and South,0,0,0,1,1
2013-12-31,2013,4,Congo (Democratic Republic),Africa Sub-Saharan,0,0,0,1,1
2013-12-31,2013,4,Ecuador,America Central and South,2,2,2,0,2
2013-12-31,2013,4,Egypt,Africa North,0,0,0,1,1
2013-12-31,2013,4,Gabon,Africa Sub-Saharan,0,0,0,1,1
2013-12-31,2013,4,"Gambia, The",Africa Sub-Saharan,10,9,1,0,1
2013-12-31,2013,4,Ghana,Africa Sub-Saharan,19,16,7,1,8
2013-12-31,2013,4,India,Asia South,109,107,73,0,73
2013-12-31,2013,4,Iraq,Middle East,0,0,0,4,4
2013-12-31,2013,4,Jamaica,America Central and South,19,16,7,0,7
2013-12-31,2013,4,Kenya,Africa Sub-Saharan,4,4,1,0,1
2013-12-31,2013,4,Kosovo,Europe Other,5,4,0,0,0
2013-12-31,2013,4,Kyrgyzstan,Asia Central,0,0,0,1,1
2013-12-31,2013,4,Latvia,EU 8,0,0,0,1,1
2013-12-31,2013,4,Liberia,Africa Sub-Saharan,1,1,0,0,0
2013-12-31,2013,4,Libya,Africa North,0,0,0,1,1
2013-12-31,2013,4,Malawi,Africa Sub-Saharan,5,4,2,0,2
2013-12-31,2013,4,Mali,Africa Sub-Saharan,2,2,0,0,0
2013-12-31,2013,4,Mauritius,Africa Sub-Saharan,7,6,5,0,5
2013-12-31,2013,4,Mongolia,Asia East,1,1,0,0,0
2013-12-31,2013,4,Nepal,Asia South,0,0,0,2,2
2013-12-31,2013,4,Nigeria,Africa Sub-Saharan,72,61,28,4,32
2013-12-31,2013,4,Pakistan,Asia South,0,0,0,25,25
2013-12-31,2013,4,Poland,EU 8,0,0,0,10,10
2013-12-31,2013,4,Serbia and Montenegro,Europe Other,1,1,0,0,0
2013-12-31,2013,4,Sierra Leone,Africa Sub-Saharan,4,3,0,0,0
2013-12-31,2013,4,South Africa,Africa Sub-Saharan,5,5,4,0,4
2013-12-31,2013,4,South Korea,Asia East,1,0,0,0,0
2013-12-31,2013,4,Syria,Middle East,0,0,0,2,2
2013-12-31,2013,4,Thailand,Asia South East,0,0,0,1,1
2013-12-31,2013,4,Togo,Africa Sub-Saharan,0,0,0,1,1
2013-12-31,2013,4,Turkey,Europe Other,0,0,0,1,1
2013-12-31,2013,4,Ukraine,Europe Other,6,6,3,0,3
2013-12-31,2013,4,United States,America North,0,0,0,1,1
2013-12-31,2013,4,Venezuela,America Central and South,0,0,0,1,1
2013-12-31,2013,4,Vietnam,Asia South East,0,0,0,4,4
2013-12-31,2013,4,Zambia,Africa Sub-Saharan,0,0,0,1,1
2014-03-31,2014,1,Afghanistan,Asia Central,0,0,0,1,1
2014-03-31,2014,1,Albania,Europe Other,142,114,27,0,27
2014-03-31,2014,1,Algeria,Africa North,0,0,0,4,4
2014-03-31,2014,1,Australia,Oceania,0,0,0,1,1
2014-03-31,2014,1,Bangladesh,Asia South,0,0,0,4,4
2014-03-31,2014,1,Bolivia,America Central and South,4,3,1,0,1
2014-03-31,2014,1,Bosnia and Herzegovina,Europe Other,1,1,0,0,0
2014-03-31,2014,1,Cameroon,Africa Sub-Saharan,0,0,0,1,1
2014-03-31,2014,1,China,Asia East,0,0,0,5,5
2014-03-31,2014,1,Costa Rica,America Central and South,0,0,0,1,1
2014-03-31,2014,1,Egypt,Africa North,0,0,0,1,1
2014-03-31,2014,1,"Gambia, The",Africa Sub-Saharan,3,1,0,0,0
2014-03-31,2014,1,Georgia,Europe Other,0,0,0,2,2
2014-03-31,2014,1,Ghana,Africa Sub-Saharan,14,13,6,0,6
2014-03-31,2014,1,Greece,EU 14,0,0,0,1,1
2014-03-31,2014,1,Guinea,Africa Sub-Saharan,0,0,0,1,1
2014-03-31,2014,1,India,Asia South,91,88,66,0,66
2014-03-31,2014,1,Iran,Middle East,0,0,0,1,1
2014-03-31,2014,1,Jamaica,America Central and South,18,12,4,0,4
2014-03-31,2014,1,Japan,Asia East,0,0,0,1,1
2014-03-31,2014,1,Kenya,Africa Sub-Saharan,3,2,0,1,1
2014-03-31,2014,1,Kosovo,Europe Other,4,3,2,0,2
2014-03-31,2014,1,Kuwait,Middle East,0,0,0,1,1
2014-03-31,2014,1,Latvia,EU 8,0,0,0,4,4
2014-03-31,2014,1,Lithuania,EU 8,0,0,0,1,1
2014-03-31,2014,1,Malawi,Africa Sub-Saharan,11,10,4,1,5
2014-03-31,2014,1,Malaysia,Asia South East,0,0,0,1,1
2014-03-31,2014,1,Mali,Africa Sub-Saharan,3,3,0,0,0
2014-03-31,2014,1,Mauritius,Africa Sub-Saharan,2,2,2,0,2
2014-03-31,2014,1,Mexico,America Central and South,0,0,0,1,1
2014-03-31,2014,1,Mongolia,Asia East,2,2,0,0,0
2014-03-31,2014,1,Morocco,Africa North,0,0,0,3,3
2014-03-31,2014,1,Namibia,Africa Sub-Saharan,0,0,0,1,1
2014-03-31,2014,1,Nigeria,Africa Sub-Saharan,57,50,18,5,23
2014-03-31,2014,1,North Macedonia,Europe Other,1,0,0,0,0
2014-03-31,2014,1,Pakistan,Asia South,0,0,0,32,32
2014-03-31,2014,1,Philippines,Asia South East,0,0,0,1,1
2014-03-31,2014,1,Poland,EU 8,0,0,0,31,31
2014-03-31,2014,1,Romania,EU 2,0,0,0,1,1
2014-03-31,2014,1,Russia,Europe Other,0,0,0,1,1
2014-03-31,2014,1,Senegal,Africa Sub-Saharan,0,0,0,2,2
2014-03-31,2014,1,Sierra Leone,Africa Sub-Saharan,4,4,2,0,2
2014-03-31,2014,1,Somalia,Africa Sub-Saharan,0,0,0,1,1
2014-03-31,2014,1,South Africa,Africa Sub-Saharan,6,6,2,0,2
2014-03-31,2014,1,Sri Lanka,Asia South,0,0,0,3,3
2014-03-31,2014,1,Syria,Middle East,0,0,0,1,1
2014-03-31,2014,1,Tunisia,Africa North,0,0,0,1,1
2014-03-31,2014,1,Ukraine,Europe Other,8,8,3,0,3
2014-03-31,2014,1,United States,America North,0,0,0,1,1
2014-03-31,2014,1,Venezuela,America Central and South,0,0,0,1,1
2014-03-31,2014,1,Zambia,Africa Sub-Saharan,0,0,0,1,1
2014-06-30,2014,2,Albania,Europe Other,188,155,40,0,40
2014-06-30,2014,2,Algeria,Africa North,0,0,0,1,1
2014-06-30,2014,2,Australia,Oceania,0,0,0,1,1
2014-06-30,2014,2,Bangladesh,Asia South,0,0,0,10,10
2014-06-30,2014,2,Bolivia,America Central and South,2,1,1,0,1
2014-06-30,2014,2,Brazil,America Central and South,4,4,3,0,3
2014-06-30,2014,2,China,Asia East,0,0,0,4,4
2014-06-30,2014,2,Colombia,America Central and South,0,0,0,1,1
2014-06-30,2014,2,"Gambia, The",Africa Sub-Saharan,12,3,0,0,0
2014-06-30,2014,2,Georgia,Europe Other,0,0,0,3,3
2014-06-30,2014,2,Ghana,Africa Sub-Saharan,13,10,4,1,5
2014-06-30,2014,2,India,Asia South,112,110,95,0,95
2014-06-30,2014,2,Indonesia,Asia South East,0,0,0,1,1
2014-06-30,2014,2,Jamaica,America Central and South,15,13,7,0,7
2014-06-30,2014,2,Japan,Asia East,0,0,0,1,1
2014-06-30,2014,2,Jordan,Middle East,0,0,0,1,1
2014-06-30,2014,2,Kenya,Africa Sub-Saharan,1,0,0,0,0
2014-06-30,2014,2,Kosovo,Europe Other,6,6,3,0,3
2014-06-30,2014,2,Liberia,Africa Sub-Saharan,1,0,0,0,0
2014-06-30,2014,2,Lithuania,EU 8,0,0,0,2,2
2014-06-30,2014,2,Malawi,Africa Sub-Saharan,4,4,0,0,0
2014-06-30,2014,2,Malaysia,Asia South East,0,0,0,2,2
2014-06-30,2014,2,Mali,Africa Sub-Saharan,4,3,1,0,1
2014-06-30,2014,2,Mauritius,Africa Sub-Saharan,7,7,5,0,5
2014-06-30,2014,2,Mongolia,Asia East,4,4,3,0,3
2014-06-30,2014,2,Namibia,Africa Sub-Saharan,0,0,0,1,1
2014-06-30,2014,2,Nigeria,Africa Sub-Saharan,85,71,31,8,39
2014-06-30,2014,2,Pakistan,Asia South,0,0,0,28,28
2014-06-30,2014,2,Peru,America Central and South,1,1,1,0,1
2014-06-30,2014,2,Philippines,Asia South East,0,0,0,2,2
2014-06-30,2014,2,Poland,EU 8,0,0,0,19,19
2014-06-30,2014,2,Portugal,EU 14,0,0,0,1,1
2014-06-30,2014,2,Russia,Europe Other,0,0,0,2,2
2014-06-30,2014,2,Senegal,Africa Sub-Saharan,0,0,0,1,1
2014-06-30,2014,2,Sierra Leone,Africa Sub-Saharan,2,2,0,0,0
2014-06-30,2014,2,South Africa,Africa Sub-Saharan,5,4,0,0,0
2014-06-30,2014,2,South Korea,Asia East,1,1,1,0,1
2014-06-30,2014,2,Spain,EU 14,0,0,0,1,1
2014-06-30,2014,2,Sri Lanka,Asia South,0,0,0,2,2
2014-06-30,2014,2,Turkey,Europe Other,0,0,0,1,1
2014-06-30,2014,2,Uganda,Africa Sub-Saharan,0,0,0,1,1
2014-06-30,2014,2,Ukraine,Europe Other,23,21,10,0,10
2014-06-30,2014,2,United States,America North,0,0,0,1,1
2014-06-30,2014,2,Venezuela,America Central and South,0,0,0,1,1
2014-06-30,2014,2,Vietnam,Asia South East,0,0,0,2,2
2014-06-30,2014,2,Zimbabwe,Africa Sub-Saharan,0,0,0,1,1
2014-09-30,2014,3,Albania,Europe Other,364,297,141,0,141
2014-09-30,2014,3,Algeria,Africa North,0,0,0,2,2
2014-09-30,2014,3,Angola,Africa Sub-Saharan,0,0,0,3,3
2014-09-30,2014,3,Bangladesh,Asia South,0,0,0,15,15
2014-09-30,2014,3,Bolivia,America Central and South,1,1,1,0,1
2014-09-30,2014,3,Brazil,America Central and South,7,7,6,0,6
2014-09-30,2014,3,Canada,America North,0,0,0,1,1
2014-09-30,2014,3,China,Asia East,0,0,0,5,5
2014-09-30,2014,3,Czech Republic,EU 8,0,0,0,1,1
2014-09-30,2014,3,Egypt,Africa North,0,0,0,4,4
2014-09-30,2014,3,"Gambia, The",Africa Sub-Saharan,43,35,6,2,8
2014-09-30,2014,3,Ghana,Africa Sub-Saharan,34,29,16,1,17
2014-09-30,2014,3,Guatemala,America Central and South,0,0,0,1,1
2014-09-30,2014,3,Hong Kong,Asia East,0,0,0,2,2
2014-09-30,2014,3,Hungary,EU 8,0,0,0,2,2
2014-09-30,2014,3,India,Asia South,216,210,168,1,169
2014-09-30,2014,3,Iran,Middle East,0,0,0,1,1
2014-09-30,2014,3,Italy,EU 14,0,0,0,1,1
2014-09-30,2014,3,Jamaica,America Central and South,40,35,15,0,15
2014-09-30,2014,3,Kenya,Africa Sub-Saharan,12,12,9,0,9
2014-09-30,2014,3,Korea (North),Asia East,0,0,0,3,3
2014-09-30,2014,3,Kosovo,Europe Other,11,9,8,0,8
2014-09-30,2014,3,Latvia,EU 8,0,0,0,4,4
2014-09-30,2014,3,Liberia,Africa Sub-Saharan,3,3,2,0,2
2014-09-30,2014,3,Lithuania,EU 8,0,0,0,1,1
2014-09-30,2014,3,Malawi,Africa Sub-Saharan,5,5,2,1,3
2014-09-30,2014,3,Malaysia,Asia South East,0,0,0,1,1
2014-09-30,2014,3,Mali,Africa Sub-Saharan,3,3,0,0,0
2014-09-30,2014,3,Mauritius,Africa Sub-Saharan,6,6,2,0,2
2014-09-30,2014,3,Moldova,Europe Other,3,3,0,0,0
2014-09-30,2014,3,Mongolia,Asia East,7,7,3,0,3
2014-09-30,2014,3,Morocco,Africa North,0,0,0,1,1
2014-09-30,2014,3,Namibia,Africa Sub-Saharan,0,0,0,1,1
2014-09-30,2014,3,Nepal,Asia South,0,0,0,2,2
2014-09-30,2014,3,Nicaragua,America Central and South,0,0,0,1,1
2014-09-30,2014,3,Nigeria,Africa Sub-Saharan,137,118,68,21,89
2014-09-30,2014,3,Pakistan,Asia South,0,0,0,56,56
2014-09-30,2014,3,Poland,EU 8,0,0,0,17,17
2014-09-30,2014,3,Portugal,EU 14,0,0,0,2,2
2014-09-30,2014,3,Romania,EU 2,0,0,0,3,3
2014-09-30,2014,3,Senegal,Africa Sub-Saharan,0,0,0,1,1
2014-09-30,2014,3,Sierra Leone,Africa Sub-Saharan,8,4,2,0,2
2014-09-30,2014,3,Somalia,Africa Sub-Saharan,0,0,0,2,2
2014-09-30,2014,3,South Africa,Africa Sub-Saharan,18,16,10,0,10
2014-09-30,2014,3,South Korea,Asia East,3,3,3,0,3
2014-09-30,2014,3,Sri Lanka,Asia South,0,0,0,1,1
2014-09-30,2014,3,Swaziland,Africa Sub-Saharan,0,0,0,1,1
2014-09-30,2014,3,Syria,Middle East,0,0,0,1,1
2014-09-30,2014,3,Turkey,Europe Other,0,0,0,1,1
2014-09-30,2014,3,Ukraine,Europe Other,45,43,29,0,29
2014-09-30,2014,3,United States,America North,0,0,0,7,7
2014-09-30,2014,3,Venezuela,America Central and South,0,0,0,1,1
2014-09-30,2014,3,Vietnam,Asia South East,0,0,0,6,6
2014-12-31,2014,4,Afghanistan,Asia Central,0,0,0,2,2
2014-12-31,2014,4,Albania,Europe Other,322,209,96,0,96
2014-12-31,2014,4,Algeria,Africa North,0,0,0,5,5
2014-12-31,2014,4,Bangladesh,Asia South,0,0,0,17,17
2014-12-31,2014,4,Bosnia and Herzegovina,Europe Other,1,1,1,0,1
2014-12-31,2014,4,Brazil,America Central and South,3,3,0,0,0
2014-12-31,2014,4,Chile,America Central and South,0,0,0,1,1
2014-12-31,2014,4,China,Asia East,0,0,0,11,11
2014-12-31,2014,4,Congo (Democratic Republic),Africa Sub-Saharan,0,0,0,1,1
2014-12-31,2014,4,Egypt,Africa North,0,0,0,4,4
2014-12-31,2014,4,Former Yugoslavia,Europe Other,2,2,1,0,1
2014-12-31,2014,4,France,EU 14,0,0,0,1,1
2014-12-31,2014,4,"Gambia, The",Africa Sub-Saharan,25,19,0,0,0
2014-12-31,2014,4,Georgia,Europe Other,0,0,0,3,3
2014-12-31,2014,4,Ghana,Africa Sub-Saharan,18,15,8,1,9
2014-12-31,2014,4,Guinea,Africa Sub-Saharan,0,0,0,1,1
2014-12-31,2014,4,India,Asia South,110,106,66,0,66
2014-12-31,2014,4,Iraq,Middle East,0,0,0,4,4
2014-12-31,2014,4,Ivory Coast,Africa Sub-Saharan,0,0,0,1,1
2014-12-31,2014,4,Jamaica,America Central and South,37,33,11,0,11
2014-12-31,2014,4,Kazakhstan,Asia Central,0,0,0,1,1
2014-12-31,2014,4,Kenya,Africa Sub-Saharan,3,2,0,1,1
2014-12-31,2014,4,Korea (North),Asia East,0,0,0,11,11
2014-12-31,2014,4,Kosovo,Europe Other,4,4,2,0,2
2014-12-31,2014,4,Kyrgyzstan,Asia Central,0,0,0,1,1
2014-12-31,2014,4,Latvia,EU 8,0,0,0,2,2
2014-12-31,2014,4,Liberia,Africa Sub-Saharan,1,0,0,0,0
2014-12-31,2014,4,Libya,Africa North,0,0,0,3,3
2014-12-31,2014,4,Lithuania,EU 8,0,0,0,7,7
2014-12-31,2014,4,Malawi,Africa Sub-Saharan,2,2,0,2,2
2014-12-31,2014,4,Malaysia,Asia South East,0,0,0,4,4
2014-12-31,2014,4,Mali,Africa Sub-Saharan,5,5,1,0,1
2014-12-31,2014,4,Mauritius,Africa Sub-Saharan,9,9,3,0,3
2014-12-31,2014,4,Moldova,Europe Other,1,0,0,0,0
2014-12-31,2014,4,Mongolia,Asia East,2,2,1,0,1
2014-12-31,2014,4,Morocco,Africa North,0,0,0,1,1
2014-12-31,2014,4,Nigeria,Africa Sub-Saharan,89,76,32,8,40
2014-12-31,2014,4,North Macedonia,Europe Other,2,2,0,0,0
2014-12-31,2014,4,Pakistan,Asia South,0,0,0,57,57
2014-12-31,2014,4,Philippines,Asia South East,0,0,0,2,2
2014-12-31,2014,4,Poland,EU 8,0,0,0,36,36
2014-12-31,2014,4,Portugal,EU 14,0,0,0,1,1
2014-12-31,2014,4,Romania,EU 2,0,0,0,3,3
2014-12-31,2014,4,Senegal,Africa Sub-Saharan,0,0,0,1,1
2014-12-31,2014,4,Sierra Leone,Africa Sub-Saharan,9,7,4,0,4
2014-12-31,2014,4,Singapore,Asia South East,0,0,0,1,1
2014-12-31,2014,4,South Africa,Africa Sub-Saharan,12,9,4,0,4
2014-12-31,2014,4,South Korea,Asia East,1,1,1,0,1
2014-12-31,2014,4,Sri Lanka,Asia South,0,0,0,4,4
2014-12-31,2014,4,Tunisia,Africa North,0,0,0,1,1
2014-12-31,2014,4,Ukraine,Europe Other,41,39,23,0,23
2014-12-31,2014,4,United States,America North,0,0,0,9,9
2014-12-31,2014,4,Vietnam,Asia South East,0,0,0,7,7
2014-12-31,2014,4,Zimbabwe,Africa Sub-Saharan,0,0,0,3,3
2015-03-31,2015,1,Afghanistan,Asia Central,0,0,0,1,1
2015-03-31,2015,1,Albania,Europe Other,462,353,150,0,150
2015-03-31,2015,1,Algeria,Africa North,0,0,0,14,14
2015-03-31,2015,1,Antigua and Barbuda,America Central and South,0,0,0,1,1
2015-03-31,2015,1,Armenia,Europe Other,0,0,0,2,2
2015-03-31,2015,1,Australia,Oceania,0,0,0,1,1
2015-03-31,2015,1,Bangladesh,Asia South,0,0,0,17,17
2015-03-31,2015,1,Bolivia,America Central and South,3,2,2,0,2
2015-03-31,2015,1,Bosnia and Herzegovina,Europe Other,1,1,1,0,1
2015-03-31,2015,1,Botswana,Africa Sub-Saharan,0,0,0,1,1
2015-03-31,2015,1,Brazil,America Central and South,1,1,1,0,1
2015-03-31,2015,1,Canada,America North,0,0,0,1,1
2015-03-31,2015,1,China,Asia East,0,0,0,18,18
2015-03-31,2015,1,Colombia,America Central and South,0,0,0,1,1
2015-03-31,2015,1,Congo (Democratic Republic),Africa Sub-Saharan,0,0,0,1,1
2015-03-31,2015,1,France,EU 14,0,0,0,1,1
2015-03-31,2015,1,"Gambia, The",Africa Sub-Saharan,36,27,1,1,2
2015-03-31,2015,1,Georgia,Europe Other,0,0,0,2,2
2015-03-31,2015,1,Ghana,Africa Sub-Saharan,31,31,12,1,13
2015-03-31,2015,1,Grenada,America Central and South,0,0,0,1,1
2015-03-31,2015,1,Guinea,Africa Sub-Saharan,0,0,0,2,2
2015-03-31,2015,1,Guyana,America Central and South,0,0,0,1,1
2015-03-31,2015,1,Haiti,America Central and South,0,0,0,1,1
2015-03-31,2015,1,Hungary,EU 8,0,0,0,1,1
2015-03-31,2015,1,India,Asia South,185,176,127,0,127
2015-03-31,2015,1,Indonesia,Asia South East,0,0,0,1,1
2015-03-31,2015,1,Iran,Middle East,0,0,0,2,2
2015-03-31,2015,1,Iraq,Middle East,0,0,0,4,4
2015-03-31,2015,1,Ireland,EU 14,0,0,0,1,1
2015-03-31,2015,1,Israel,Middle East,0,0,0,2,2
2015-03-31,2015,1,Jamaica,America Central and South,35,34,12,4,16
2015-03-31,2015,1,Kenya,Africa Sub-Saharan,10,9,4,1,5
2015-03-31,2015,1,Korea (North),Asia East,0,0,0,5,5
2015-03-31,2015,1,Kosovo,Europe Other,9,9,6,0,6
2015-03-31,2015,1,Latvia,EU 8,0,0,0,3,3
2015-03-31,2015,1,Lithuania,EU 8,0,0,0,7,7
2015-03-31,2015,1,Malawi,Africa Sub-Saharan,17,14,7,6,13
2015-03-31,2015,1,Mali,Africa Sub-Saharan,2,2,1,0,1
2015-03-31,2015,1,Mauritius,Africa Sub-Saharan,13,12,7,0,7
2015-03-31,2015,1,Moldova,Europe Other,1,1,0,0,0
2015-03-31,2015,1,Mongolia,Asia East,7,5,4,0,4
2015-03-31,2015,1,Morocco,Africa North,0,0,0,5,5
2015-03-31,2015,1,Nepal,Asia South,0,0,0,4,4
2015-03-31,2015,1,Nigeria,Africa Sub-Saharan,156,134,52,21,73
2015-03-31,2015,1,Oman,Middle East,0,0,0,1,1
2015-03-31,2015,1,Pakistan,Asia South,0,0,0,96,96
2015-03-31,2015,1,Philippines,Asia South East,0,0,0,3,3
2015-03-31,2015,1,Poland,EU 8,0,0,0,26,26
2015-03-31,2015,1,Refugee,Other,0,0,0,1,1
2015-03-31,2015,1,Romania,EU 2,0,0,0,1,1
2015-03-31,2015,1,Senegal,Africa Sub-Saharan,0,0,0,2,2
2015-03-31,2015,1,Sierra Leone,Africa Sub-Saharan,8,8,2,0,2
2015-03-31,2015,1,Somalia,Africa Sub-Saharan,0,0,0,1,1
2015-03-31,2015,1,South Africa,Africa Sub-Saharan,14,13,8,0,8
2015-03-31,2015,1,South Korea,Asia East,4,3,1,0,1
2015-03-31,2015,1,Spain,EU 14,0,0,0,1,1
2015-03-31,2015,1,Sri Lanka,Asia South,0,0,0,4,4
2015-03-31,2015,1,Sudan,Africa North,0,0,0,1,1
2015-03-31,2015,1,Tajikistan,Asia Central,0,0,0,1,1
2015-03-31,2015,1,Tanzania,Africa Sub-Saharan,0,0,0,1,1
2015-03-31,2015,1,Trinidad and Tobago,America Central and South,0,0,0,2,2
2015-03-31,2015,1,Turkey,Europe Other,0,0,0,3,3
2015-03-31,2015,1,Uganda,Africa Sub-Saharan,0,0,0,1,1
2015-03-31,2015,1,Ukraine,Europe Other,44,43,23,0,23
2015-03-31,2015,1,United States,America North,0,0,0,1,1
2015-03-31,2015,1,Venezuela,America Central and South,0,0,0,2,2
2015-03-31,2015,1,Vietnam,Asia South East,0,0,0,10,10
2015-03-31,2015,1,Zambia,Africa Sub-Saharan,0,0,0,3,3
2015-03-31,2015,1,Zimbabwe,Africa Sub-Saharan,0,0,0,3,3
2015-06-30,2015,2,Albania,Europe Other,316,217,88,0,88
2015-06-30,2015,2,Algeria,Africa North,0,0,0,6,6
2015-06-30,2015,2,Australia,Oceania,0,0,0,1,1
2015-06-30,2015,2,Bangladesh,Asia South,0,0,0,9,9
2015-06-30,2015,2,Barbados,America Central and South,0,0,0,1,1
2015-06-30,2015,2,Belgium,EU 14,0,0,0,1,1
2015-06-30,2015,2,Bolivia,America Central and South,1,1,1,0,1
2015-06-30,2015,2,Bosnia and Herzegovina,Europe Other,1,1,1,0,1
2015-06-30,2015,2,Botswana,Africa Sub-Saharan,0,0,0,1,1
2015-06-30,2015,2,Brazil,America Central and South,2,1,1,0,1
2015-06-30,2015,2,Burma,Asia South East,0,0,0,1,1
2015-06-30,2015,2,Cameroon,Africa Sub-Saharan,0,0,0,1,1
2015-06-30,2015,2,Canada,America North,0,0,0,1,1
2015-06-30,2015,2,China,Asia East,0,0,0,5,5
2015-06-30,2015,2,Colombia,America Central and South,0,0,0,1,1
2015-06-30,2015,2,Czech Republic,EU 8,0,0,0,1,1
2015-06-30,2015,2,El Salvador,America Central and South,0,0,0,3,3
2015-06-30,2015,2,"Gambia, The",Africa Sub-Saharan,18,14,0,1,1
2015-06-30,2015,2,Georgia,Europe Other,0,0,0,3,3
2015-06-30,2015,2,Ghana,Africa Sub-Saharan,17,14,6,0,6
2015-06-30,2015,2,Greece,EU 14,0,0,0,1,1
2015-06-30,2015,2,India,Asia South,117,117,99,0,99
2015-06-30,2015,2,Iran,Middle East,0,0,0,1,1
2015-06-30,2015,2,Ireland,EU 14,0,0,0,1,1
2015-06-30,2015,2,Jamaica,America Central and South,0,0,0,5,5
2015-06-30,2015,2,Jordan,Middle East,0,0,0,1,1
2015-06-30,2015,2,Kenya,Africa Sub-Saharan,8,7,2,1,3
2015-06-30,2015,2,Korea (North),Asia East,0,0,0,4,4
2015-06-30,2015,2,Kosovo,Europe Other,4,4,4,0,4
2015-06-30,2015,2,Latvia,EU 8,0,0,0,2,2
2015-06-30,2015,2,Liberia,Africa Sub-Saharan,0,0,0,1,1
2015-06-30,2015,2,Lithuania,EU 8,0,0,0,11,11
2015-06-30,2015,2,Malawi,Africa Sub-Saharan,3,1,0,1,1
2015-06-30,2015,2,Malaysia,Asia South East,0,0,0,4,4
2015-06-30,2015,2,Mali,Africa Sub-Saharan,3,3,0,0,0
2015-06-30,2015,2,Mauritius,Africa Sub-Saharan,2,2,2,0,2
2015-06-30,2015,2,Mongolia,Asia East,2,1,0,0,0
2015-06-30,2015,2,Morocco,Africa North,0,0,0,1,1
2015-06-30,2015,2,Namibia,Africa Sub-Saharan,0,0,0,1,1
2015-06-30,2015,2,Nepal,Asia South,0,0,0,1,1
2015-06-30,2015,2,Nigeria,Africa Sub-Saharan,83,73,41,14,55
2015-06-30,2015,2,North Macedonia,Europe Other,1,1,0,0,0
2015-06-30,2015,2,Pakistan,Asia South,0,0,0,38,38
2015-06-30,2015,2,Philippines,Asia South East,0,0,0,3,3
2015-06-30,2015,2,Poland,EU 8,0,0,0,22,22
2015-06-30,2015,2,Portugal,EU 14,0,0,0,1,1
2015-06-30,2015,2,Romania,EU 2,0,0,0,5,5
2015-06-30,2015,2,Senegal,Africa Sub-Saharan,0,0,0,1,1
2015-06-30,2015,2,Sierra Leone,Africa Sub-Saharan,1,0,0,0,0
2015-06-30,2015,2,Somalia,Africa Sub-Saharan,0,0,0,1,1
2015-06-30,2015,2,South Africa,Africa Sub-Saharan,13,12,1,0,1
2015-06-30,2015,2,South Korea,Asia East,3,3,3,0,3
2015-06-30,2015,2,Sri Lanka,Asia South,0,0,0,1,1
2015-06-30,2015,2,St Lucia,America Central and South,0,0,0,1,1
2015-06-30,2015,2,Syria,Middle East,0,0,0,1,1
2015-06-30,2015,2,Tanzania,Africa Sub-Saharan,0,0,0,1,1
2015-06-30,2015,2,Trinidad and Tobago,America Central and South,0,0,0,1,1
2015-06-30,2015,2,Turkey,Europe Other,0,0,0,1,1
2015-06-30,2015,2,Uganda,Africa Sub-Saharan,0,0,0,1,1
2015-06-30,2015,2,Ukraine,Europe Other,39,37,22,0,22
2015-06-30,2015,2,United States,America North,0,0,0,2,2
2015-06-30,2015,2,Vietnam,Asia South East,0,0,0,7,7
2015-06-30,2015,2,Yemen,Middle East,0,0,0,1,1
2015-06-30,2015,2,Zambia,Africa Sub-Saharan,0,0,0,1,1
2015-06-30,2015,2,Zimbabwe,Africa Sub-Saharan,0,0,0,3,3
2015-09-30,2015,3,Afghanistan,Asia Central,0,0,0,2,2
2015-09-30,2015,3,Albania,Europe Other,257,207,98,0,98
2015-09-30,2015,3,Algeria,Africa North,0,0,0,4,4
2015-09-30,2015,3,Argentina,America Central and South,0,0,0,1,1
2015-09-30,2015,3,Bangladesh,Asia South,0,0,0,8,8
2015-09-30,2015,3,Belgium,EU 14,0,0,0,1,1
2015-09-30,2015,3,Bolivia,America Central and South,3,3,2,0,2
2015-09-30,2015,3,Brazil,America Central and South,2,2,1,0,1
2015-09-30,2015,3,Bulgaria,EU 2,0,0,0,1,1
2015-09-30,2015,3,Cambodia,Asia South East,0,0,0,1,1
2015-09-30,2015,3,Cameroon,Africa Sub-Saharan,0,0,0,1,1
2015-09-30,2015,3,Chad,Africa Sub-Saharan,0,0,0,1,1
2015-09-30,2015,3,China,Asia East,0,0,0,4,4
2015-09-30,2015,3,Cuba,America Central and South,0,0,0,1,1
2015-09-30,2015,3,Czech Republic,EU 8,0,0,0,1,1
2015-09-30,2015,3,Ecuador,America Central and South,1,1,0,0,0
2015-09-30,2015,3,Egypt,Africa North,0,0,0,2,2
2015-09-30,2015,3,Eritrea,Africa Sub-Saharan,0,0,0,1,1
2015-09-30,2015,3,Estonia,EU 8,0,0,0,1,1
2015-09-30,2015,3,Ethiopia,Africa Sub-Saharan,0,0,0,1,1
2015-09-30,2015,3,"Gambia, The",Africa Sub-Saharan,28,26,2,0,2
2015-09-30,2015,3,Georgia,Europe Other,0,0,0,2,2
2015-09-30,2015,3,Ghana,Africa Sub-Saharan,26,24,9,0,9
2015-09-30,2015,3,Guyana,America Central and South,0,0,0,1,1
2015-09-30,2015,3,Hungary,EU 8,0,0,0,1,1
2015-09-30,2015,3,India,Asia South,146,142,120,0,120
2015-09-30,2015,3,Ireland,EU 14,0,0,0,1,1
2015-09-30,2015,3,Israel,Middle East,0,0,0,1,1
2015-09-30,2015,3,Jamaica,America Central and South,0,0,0,9,9
2015-09-30,2015,3,Kenya,Africa Sub-Saharan,5,4,1,1,2
2015-09-30,2015,3,Korea (North),Asia East,0,0,0,5,5
2015-09-30,2015,3,Kosovo,Europe Other,7,7,1,0,1
2015-09-30,2015,3,Latvia,EU 8,0,0,0,9,9
2015-09-30,2015,3,Lithuania,EU 8,0,0,0,6,6
2015-09-30,2015,3,Malawi,Africa Sub-Saharan,3,1,0,0,0
2015-09-30,2015,3,Mali,Africa Sub-Saharan,4,4,0,0,0
2015-09-30,2015,3,Mauritius,Africa Sub-Saharan,10,9,5,0,5
2015-09-30,2015,3,Moldova,Europe Other,1,0,0,0,0
2015-09-30,2015,3,Mongolia,Asia East,2,2,1,0,1
2015-09-30,2015,3,Morocco,Africa North,0,0,0,1,1
2015-09-30,2015,3,Namibia,Africa Sub-Saharan,0,0,0,1,1
2015-09-30,2015,3,Nepal,Asia South,0,0,0,4,4
2015-09-30,2015,3,Nigeria,Africa Sub-Saharan,96,82,44,17,61
2015-09-30,2015,3,Pakistan,Asia South,0,0,0,38,38
2015-09-30,2015,3,Poland,EU 8,0,0,0,14,14
2015-09-30,2015,3,Portugal,EU 14,0,0,0,1,1
2015-09-30,2015,3,Romania,EU 2,0,0,0,3,3
2015-09-30,2015,3,Russia,Europe Other,0,0,0,1,1
2015-09-30,2015,3,Senegal,Africa Sub-Saharan,0,0,0,1,1
2015-09-30,2015,3,Serbia and Montenegro,Europe Other,1,1,0,0,0
2015-09-30,2015,3,Sierra Leone,Africa Sub-Saharan,5,5,3,1,4
2015-09-30,2015,3,Slovakia,EU 8,0,0,0,1,1
2015-09-30,2015,3,Somalia,Africa Sub-Saharan,0,0,0,1,1
2015-09-30,2015,3,South Africa,Africa Sub-Saharan,13,10,5,0,5
2015-09-30,2015,3,South Korea,Asia East,3,3,3,0,3
2015-09-30,2015,3,Sri Lanka,Asia South,0,0,0,3,3
2015-09-30,2015,3,Stateless,Other,0,0,0,1,1
2015-09-30,2015,3,Syria,Middle East,0,0,0,1,1
2015-09-30,2015,3,Tanzania,Africa Sub-Saharan,0,0,0,1,1
2015-09-30,2015,3,Tunisia,Africa North,0,0,0,1,1
2015-09-30,2015,3,Ukraine,Europe Other,44,44,35,0,35
2015-09-30,2015,3,United States,America North,0,0,0,3,3
2015-09-30,2015,3,Vietnam,Asia South East,0,0,0,3,3
2015-09-30,2015,3,Zimbabwe,Africa Sub-Saharan,0,0,0,4,4
2015-12-31,2015,4,Afghanistan,Asia Central,0,0,0,1,1
2015-12-31,2015,4,Albania,Europe Other,381,292,102,0,102
2015-12-31,2015,4,Algeria,Africa North,0,0,0,5,5
2015-12-31,2015,4,Angola,Africa Sub-Saharan,0,0,0,1,1
2015-12-31,2015,4,Bangladesh,Asia South,0,0,0,10,10
2015-12-31,2015,4,Bolivia,America Central and South,2,2,1,0,1
2015-12-31,2015,4,Bosnia and Herzegovina,Europe Other,1,1,1,0,1
2015-12-31,2015,4,Botswana,Africa Sub-Saharan,0,0,0,1,1
2015-12-31,2015,4,Brazil,America Central and South,7,7,5,0,5
2015-12-31,2015,4,Bulgaria,EU 2,0,0,0,2,2
2015-12-31,2015,4,Canada,America North,0,0,0,2,2
2015-12-31,2015,4,China,Asia East,0,0,0,12,12
2015-12-31,2015,4,Colombia,America Central and South,0,0,0,1,1
2015-12-31,2015,4,Czech Republic,EU 8,0,0,0,1,1
2015-12-31,2015,4,Dominica,America Central and South,0,0,0,1,1
2015-12-31,2015,4,Egypt,Africa North,0,0,0,2,2
2015-12-31,2015,4,Eritrea,Africa Sub-Saharan,0,0,0,2,2
2015-12-31,2015,4,"Gambia, The",Africa Sub-Saharan,23,22,1,0,1
2015-12-31,2015,4,Georgia,Europe Other,0,0,0,3,3
2015-12-31,2015,4,Germany,EU 14,0,0,0,1,1
2015-12-31,2015,4,Ghana,Africa Sub-Saharan,28,26,14,1,15
2015-12-31,2015,4,Hong Kong,Asia East,0,0,0,1,1
2015-12-31,2015,4,Hungary,EU 8,0,0,0,1,1
2015-12-31,2015,4,India,Asia South,198,196,169,0,169
2015-12-31,2015,4,Indonesia,Asia South East,0,0,0,1,1
2015-12-31,2015,4,Iraq,Middle East,0,0,0,1,1
2015-12-31,2015,4,Jamaica,America Central and South,0,0,0,16,16
2015-12-31,2015,4,Kenya,Africa Sub-Saharan,9,9,0,0,0
2015-12-31,2015,4,Korea (North),Asia East,0,0,0,5,5
2015-12-31,2015,4,Kosovo,Europe Other,6,6,3,0,3
2015-12-31,2015,4,Latvia,EU 8,0,0,0,3,3
2015-12-31,2015,4,Liberia,Africa Sub-Saharan,2,2,0,0,0
2015-12-31,2015,4,Lithuania,EU 8,0,0,0,1,1
2015-12-31,2015,4,Malawi,Africa Sub-Saharan,5,4,0,0,0
2015-12-31,2015,4,Malaysia,Asia South East,0,0,0,2,2
2015-12-31,2015,4,Mali,Africa Sub-Saharan,3,3,1,0,1
2015-12-31,2015,4,Mauritius,Africa Sub-Saharan,13,13,12,0,12
2015-12-31,2015,4,Mongolia,Asia East,2,2,1,0,1
2015-12-31,2015,4,Morocco,Africa North,0,0,0,1,1
2015-12-31,2015,4,Namibia,Africa Sub-Saharan,0,0,0,2,2
2015-12-31,2015,4,Nepal,Asia South,0,0,0,6,6
2015-12-31,2015,4,Nigeria,Africa Sub-Saharan,112,101,51,15,66
2015-12-31,2015,4,Pakistan,Asia South,0,0,0,72,72
2015-12-31,2015,4,Philippines,Asia South East,0,0,0,1,1
2015-12-31,2015,4,Poland,EU 8,0,0,0,7,7
2015-12-31,2015,4,Portugal,EU 14,0,0,0,1,1
2015-12-31,2015,4,Refugee,Other,0,0,0,1,1
2015-12-31,2015,4,Romania,EU 2,0,0,0,3,3
2015-12-31,2015,4,Sierra Leone,Africa Sub-Saharan,8,8,3,0,3
2015-12-31,2015,4,Slovakia,EU 8,0,0,0,3,3
2015-12-31,2015,4,South Africa,Africa Sub-Saharan,19,17,8,0,8
2015-12-31,2015,4,South Korea,Asia East,2,2,2,0,2
2015-12-31,2015,4,Sri Lanka,Asia South,0,0,0,1,1
2015-12-31,2015,4,St Lucia,America Central and South,0,0,0,1,1
2015-12-31,2015,4,St Vincent and the Grenadines,America Central and South,0,0,0,1,1
2015-12-31,2015,4,Syria,Middle East,0,0,0,1,1
2015-12-31,2015,4,Tanzania,Africa Sub-Saharan,0,0,0,1,1
2015-12-31,2015,4,Thailand,Asia South East,0,0,0,1,1
2015-12-31,2015,4,Togo,Africa Sub-Saharan,0,0,0,1,1
2015-12-31,2015,4,Trinidad and Tobago,America Central and South,0,0,0,1,1
2015-12-31,2015,4,Tunisia,Africa North,0,0,0,1,1
2015-12-31,2015,4,Turkey,Europe Other,0,0,0,1,1
2015-12-31,2015,4,Uganda,Africa Sub-Saharan,0,0,0,3,3
2015-12-31,2015,4,Ukraine,Europe Other,42,42,26,0,26
2015-12-31,2015,4,United States,America North,0,0,0,1,1
2015-12-31,2015,4,Vietnam,Asia South East,0,0,0,9,9
2015-12-31,2015,4,Zambia,Africa Sub-Saharan,0,0,0,1,1
2016-03-31,2016,1,Afghanistan,Asia Central,0,0,0,1,1
2016-03-31,2016,1,Albania,Europe Other,249,171,66,0,66
2016-03-31,2016,1,Algeria,Africa North,0,0,0,1,1
2016-03-31,2016,1,Bangladesh,Asia South,0,0,0,47,47
2016-03-31,2016,1,Barbados,America Central and South,0,0,0,1,1
2016-03-31,2016,1,Belize,America Central and South,0,0,0,1,1
2016-03-31,2016,1,Botswana,Africa Sub-Saharan,0,0,0,1,1
2016-03-31,2016,1,Brazil,America Central and South,5,5,5,0,5
2016-03-31,2016,1,Bulgaria,EU 2,0,0,0,1,1
2016-03-31,2016,1,Cameroon,Africa Sub-Saharan,0,0,0,2,2
2016-03-31,2016,1,Canada,America North,0,0,0,1,1
2016-03-31,2016,1,China,Asia East,0,0,0,13,13
2016-03-31,2016,1,Colombia,America Central and South,0,0,0,1,1
2016-03-31,2016,1,Congo (Democratic Republic),Africa Sub-Saharan,0,0,0,1,1
2016-03-31,2016,1,Ecuador,America Central and South,2,2,1,0,1
2016-03-31,2016,1,Egypt,Africa North,0,0,0,3,3
2016-03-31,2016,1,El Salvador,America Central and South,0,0,0,1,1
2016-03-31,2016,1,Estonia,EU 8,0,0,0,1,1
2016-03-31,2016,1,Ethiopia,Africa Sub-Saharan,0,0,0,1,1
2016-03-31,2016,1,"Gambia, The",Africa Sub-Saharan,17,17,3,1,4
2016-03-31,2016,1,Georgia,Europe Other,0,0,0,3,3
2016-03-31,2016,1,Ghana,Africa Sub-Saharan,32,31,17,0,17
2016-03-31,2016,1,India,Asia South,267,266,239,0,239
2016-03-31,2016,1,Iran,Middle East,0,0,0,1,1
2016-03-31,2016,1,Jamaica,America Central and South,0,0,0,21,21
2016-03-31,2016,1,Kenya,Africa Sub-Saharan,7,6,5,2,7
2016-03-31,2016,1,Korea (North),Asia East,0,0,0,5,5
2016-03-31,2016,1,Kosovo,Europe Other,2,2,1,0,1
2016-03-31,2016,1,Lebanon,Middle East,0,0,0,1,1
2016-03-31,2016,1,Liberia,Africa Sub-Saharan,2,2,2,0,2
2016-03-31,2016,1,Lithuania,EU 8,0,0,0,1,1
2016-03-31,2016,1,Malawi,Africa Sub-Saharan,6,4,1,1,2
2016-03-31,2016,1,Malaysia,Asia South East,0,0,0,1,1
2016-03-31,2016,1,Mali,Africa Sub-Saharan,3,3,1,0,1
2016-03-31,2016,1,Mauritius,Africa Sub-Saharan,4,4,2,0,2
2016-03-31,2016,1,Mongolia,Asia East,1,1,0,0,0
2016-03-31,2016,1,Namibia,Africa Sub-Saharan,0,0,0,1,1
2016-03-31,2016,1,Nepal,Asia South,0,0,0,7,7
2016-03-31,2016,1,Nigeria,Africa Sub-Saharan,96,89,45,21,66
2016-03-31,2016,1,Pakistan,Asia South,0,0,0,83,83
2016-03-31,2016,1,Philippines,Asia South East,0,0,0,5,5
2016-03-31,2016,1,Poland,EU 8,0,0,0,2,2
2016-03-31,2016,1,Portugal,EU 14,0,0,0,2,2
2016-03-31,2016,1,Romania,EU 2,0,0,0,1,1
2016-03-31,2016,1,Saudi Arabia,Middle East,0,0,0,1,1
2016-03-31,2016,1,Sierra Leone,Africa Sub-Saharan,5,5,5,0,5
2016-03-31,2016,1,South Africa,Africa Sub-Saharan,1,1,1,0,1
2016-03-31,2016,1,Sri Lanka,Asia South,0,0,0,3,3
2016-03-31,2016,1,St Kitts and Nevis,America Central and South,0,0,0,1,1
2016-03-31,2016,1,Tanzania,Africa Sub-Saharan,0,0,0,2,2
2016-03-31,2016,1,Thailand,Asia South East,0,0,0,1,1
2016-03-31,2016,1,Togo,Africa Sub-Saharan,0,0,0,1,1
2016-03-31,2016,1,Trinidad and Tobago,America Central and South,0,0,0,4,4
2016-03-31,2016,1,Tunisia,Africa North,0,0,0,1,1
2016-03-31,2016,1,Turkey,Europe Other,0,0,0,1,1
2016-03-31,2016,1,Ukraine,Europe Other,26,26,9,0,9
2016-03-31,2016,1,United States,America North,0,0,0,3,3
2016-03-31,2016,1,Uzbekistan,Asia Central,0,0,0,1,1
2016-03-31,2016,1,Vietnam,Asia South East,0,0,0,6,6
2016-03-31,2016,1,Zambia,Africa Sub-Saharan,0,0,0,1,1
2016-03-31,2016,1,Zimbabwe,Africa Sub-Saharan,0,0,0,1,1
2016-06-30,2016,2,Albania,Europe Other,222,166,68,0,68
2016-06-30,2016,2,Algeria,Africa North,0,0,0,4,4
2016-06-30,2016,2,Bangladesh,Asia South,0,0,0,35,35
2016-06-30,2016,2,Bolivia,America Central and South,2,2,2,0,2
2016-06-30,2016,2,Bosnia and Herzegovina,Europe Other,1,1,0,0,0
2016-06-30,2016,2,Brazil,America Central and South,2,2,1,0,1
2016-06-30,2016,2,Cameroon,Africa Sub-Saharan,0,0,0,1,1
2016-06-30,2016,2,Canada,America North,0,0,0,1,1
2016-06-30,2016,2,China,Asia East,0,0,0,21,21
2016-06-30,2016,2,Colombia,America Central and South,0,0,0,1,1
2016-06-30,2016,2,Congo (Democratic Republic),Africa Sub-Saharan,0,0,0,2,2
2016-06-30,2016,2,Cuba,America Central and South,0,0,0,1,1
2016-06-30,2016,2,Dominica,America Central and South,0,0,0,1,1
2016-06-30,2016,2,Egypt,Africa North,0,0,0,5,5
2016-06-30,2016,2,"Gambia, The",Africa Sub-Saharan,13,12,1,0,1
2016-06-30,2016,2,Ghana,Africa Sub-Saharan,27,24,12,3,15
2016-06-30,2016,2,Guinea,Africa Sub-Saharan,0,0,0,1,1
2016-06-30,2016,2,India,Asia South,189,189,150,0,150
2016-06-30,2016,2,Iraq,Middle East,0,0,0,5,5
2016-06-30,2016,2,Jamaica,America Central and South,0,0,0,18,18
2016-06-30,2016,2,Jordan,Middle East,0,0,0,1,1
2016-06-30,2016,2,Kenya,Africa Sub-Saharan,5,5,1,0,1
2016-06-30,2016,2,Korea (North),Asia East,0,0,0,2,2
2016-06-30,2016,2,Kosovo,Europe Other,2,1,1,0,1
2016-06-30,2016,2,Latvia,EU 8,0,0,0,1,1
2016-06-30,2016,2,Lithuania,EU 8,0,0,0,2,2
2016-06-30,2016,2,Malawi,Africa Sub-Saharan,3,3,2,0,2
2016-06-30,2016,2,Malaysia,Asia South East,0,0,0,4,4
2016-06-30,2016,2,Mali,Africa Sub-Saharan,1,1,0,0,0
2016-06-30,2016,2,Mauritius,Africa Sub-Saharan,11,9,7,0,7
2016-06-30,2016,2,Mongolia,Asia East,3,3,1,0,1
2016-06-30,2016,2,Morocco,Africa North,0,0,0,1,1
2016-06-30,2016,2,Namibia,Africa Sub-Saharan,0,0,0,1,1
2016-06-30,2016,2,Nepal,Asia South,0,0,0,10,10
2016-06-30,2016,2,Nigeria,Africa Sub-Saharan,94,87,40,7,47
2016-06-30,2016,2,Pakistan,Asia South,0,0,0,90,90
2016-06-30,2016,2,Philippines,Asia South East,0,0,0,2,2
2016-06-30,2016,2,Refugee,Other,0,0,0,1,1
2016-06-30,2016,2,Romania,EU 2,0,0,0,1,1
2016-06-30,2016,2,Serbia and Montenegro,Europe Other,1,1,0,0,0
2016-06-30,2016,2,Sierra Leone,Africa Sub-Saharan,5,4,2,1,3
2016-06-30,2016,2,Somalia,Africa Sub-Saharan,0,0,0,2,2
2016-06-30,2016,2,South Africa,Africa Sub-Saharan,8,8,5,0,5
2016-06-30,2016,2,Spain,EU 14,0,0,0,1,1
2016-06-30,2016,2,Sri Lanka,Asia South,0,0,0,1,1
2016-06-30,2016,2,St Lucia,America Central and South,0,0,0,1,1
2016-06-30,2016,2,Syria,Middle East,0,0,0,2,2
2016-06-30,2016,2,Tanzania,Africa Sub-Saharan,0,0,0,1,1
2016-06-30,2016,2,Thailand,Asia South East,0,0,0,1,1
2016-06-30,2016,2,Trinidad and Tobago,America Central and South,0,0,0,2,2
2016-06-30,2016,2,Tunisia,Africa North,0,0,0,1,1
2016-06-30,2016,2,Turkey,Europe Other,0,0,0,3,3
2016-06-30,2016,2,Uganda,Africa Sub-Saharan,0,0,0,1,1
2016-06-30,2016,2,Ukraine,Europe Other,13,13,6,0,6
2016-06-30,2016,2,United States,America North,0,0,0,8,8
2016-06-30,2016,2,Uzbekistan,Asia Central,0,0,0,1,1
2016-06-30,2016,2,Venezuela,America Central and South,0,0,0,1,1
2016-06-30,2016,2,Vietnam,Asia South East,0,0,0,11,11
2016-06-30,2016,2,Zimbabwe,Africa Sub-Saharan,0,0,0,3,3
2016-09-30,2016,3,Albania,Europe Other,169,127,49,0,49
2016-09-30,2016,3,Algeria,Africa North,0,0,0,5,5
2016-09-30,2016,3,Angola,Africa Sub-Saharan,0,0,0,1,1
2016-09-30,2016,3,Bangladesh,Asia South,0,0,0,25,25
2016-09-30,2016,3,Barbados,America Central and South,0,0,0,1,1
2016-09-30,2016,3,Bolivia,America Central and South,2,2,1,0,1
2016-09-30,2016,3,Botswana,Africa Sub-Saharan,0,0,0,1,1
2016-09-30,2016,3,Brazil,America Central and South,5,5,4,0,4
2016-09-30,2016,3,China,Asia East,0,0,0,8,8
2016-09-30,2016,3,Congo (Democratic Republic),Africa Sub-Saharan,0,0,0,2,2
2016-09-30,2016,3,Dominica,America Central and South,0,0,0,2,2
2016-09-30,2016,3,Egypt,Africa North,0,0,0,2,2
2016-09-30,2016,3,"Gambia, The",Africa Sub-Saharan,16,13,1,0,1
2016-09-30,2016,3,Georgia,Europe Other,0,0,0,2,2
2016-09-30,2016,3,Ghana,Africa Sub-Saharan,29,27,12,2,14
2016-09-30,2016,3,Guinea,Africa Sub-Saharan,0,0,0,1,1
2016-09-30,2016,3,India,Asia South,243,240,193,0,193
2016-09-30,2016,3,Iraq,Middle East,0,0,0,6,6
2016-09-30,2016,3,Israel,Middle East,0,0,0,1,1
2016-09-30,2016,3,Jamaica,America Central and South,0,0,0,22,22
2016-09-30,2016,3,Kenya,Africa Sub-Saharan,4,4,2,2,4
2016-09-30,2016,3,Korea (North),Asia East,0,0,0,3,3
2016-09-30,2016,3,Kosovo,Europe Other,2,2,1,0,1
2016-09-30,2016,3,Malawi,Africa Sub-Saharan,6,5,1,3,4
2016-09-30,2016,3,Malaysia,Asia South East,0,0,0,2,2
2016-09-30,2016,3,Mali,Africa Sub-Saharan,3,3,1,0,1
2016-09-30,2016,3,Mauritius,Africa Sub-Saharan,12,12,8,0,8
2016-09-30,2016,3,Mexico,America Central and South,0,0,0,2,2
2016-09-30,2016,3,Moldova,Europe Other,1,1,0,0,0
2016-09-30,2016,3,Mongolia,Asia East,3,2,2,0,2
2016-09-30,2016,3,Morocco,Africa North,0,0,0,4,4
2016-09-30,2016,3,Nepal,Asia South,0,0,0,12,12
2016-09-30,2016,3,Netherlands,EU 14,0,0,0,1,1
2016-09-30,2016,3,Nigeria,Africa Sub-Saharan,100,94,38,14,52
2016-09-30,2016,3,North Macedonia,Europe Other,2,1,1,0,1
2016-09-30,2016,3,Pakistan,Asia South,0,0,0,88,88
2016-09-30,2016,3,Philippines,Asia South East,0,0,0,3,3
2016-09-30,2016,3,Russia,Europe Other,0,0,0,1,1
2016-09-30,2016,3,Rwanda,Africa Sub-Saharan,0,0,0,2,2
2016-09-30,2016,3,Sierra Leone,Africa Sub-Saharan,3,3,2,1,3
2016-09-30,2016,3,South Africa,Africa Sub-Saharan,9,7,3,0,3
2016-09-30,2016,3,South Korea,Asia East,2,2,2,0,2
2016-09-30,2016,3,Sri Lanka,Asia South,0,0,0,4,4
2016-09-30,2016,3,Trinidad and Tobago,America Central and South,0,0,0,1,1
2016-09-30,2016,3,Tunisia,Africa North,0,0,0,1,1
2016-09-30,2016,3,Turkey,Europe Other,0,0,0,2,2
2016-09-30,2016,3,Uganda,Africa Sub-Saharan,0,0,0,2,2
2016-09-30,2016,3,Ukraine,Europe Other,10,10,3,0,3
2016-09-30,2016,3,United States,America North,0,0,0,1,1
2016-09-30,2016,3,Vietnam,Asia South East,0,0,0,4,4
2016-09-30,2016,3,Zimbabwe,Africa Sub-Saharan,0,0,0,1,1
2016-12-31,2016,4,Albania,Europe Other,179,133,65,0,65
2016-12-31,2016,4,Algeria,Africa North,0,0,0,1,1
2016-12-31,2016,4,Argentina,America Central and South,0,0,0,1,1
2016-12-31,2016,4,Bangladesh,Asia South,0,0,0,33,33
2016-12-31,2016,4,Bolivia,America Central and South,2,2,1,0,1
2016-12-31,2016,4,Brazil,America Central and South,2,2,2,0,2
2016-12-31,2016,4,Cameroon,Africa Sub-Saharan,0,0,0,1,1
2016-12-31,2016,4,China,Asia East,0,0,0,11,11
2016-12-31,2016,4,Egypt,Africa North,0,0,0,1,1
2016-12-31,2016,4,Fiji,Oceania,0,0,0,1,1
2016-12-31,2016,4,"Gambia, The",Africa Sub-Saharan,19,17,2,1,3
2016-12-31,2016,4,Ghana,Africa Sub-Saharan,36,34,23,1,24
2016-12-31,2016,4,Guyana,America Central and South,0,0,0,3,3
2016-12-31,2016,4,India,Asia South,200,199,151,0,151
2016-12-31,2016,4,Iran,Middle East,0,0,0,1,1
2016-12-31,2016,4,Iraq,Middle East,0,0,0,1,1
2016-12-31,2016,4,Jamaica,America Central and South,0,0,0,16,16
2016-12-31,2016,4,Kenya,Africa Sub-Saharan,4,4,1,0,1
2016-12-31,2016,4,Kosovo,Europe Other,1,1,1,0,1
2016-12-31,2016,4,Liberia,Africa Sub-Saharan,1,1,0,0,0
2016-12-31,2016,4,Malawi,Africa Sub-Saharan,3,3,1,2,3
2016-12-31,2016,4,Malaysia,Asia South East,0,0,0,3,3
2016-12-31,2016,4,Mauritius,Africa Sub-Saharan,11,11,6,0,6
2016-12-31,2016,4,Mongolia,Asia East,1,1,1,0,1
2016-12-31,2016,4,Nepal,Asia South,0,0,0,8,8
2016-12-31,2016,4,Niger,Africa Sub-Saharan,0,0,0,1,1
2016-12-31,2016,4,Nigeria,Africa Sub-Saharan,116,112,47,15,62
2016-12-31,2016,4,Other and unknown,Other,0,0,0,1,1
2016-12-31,2016,4,Pakistan,Asia South,0,0,0,81,81
2016-12-31,2016,4,Philippines,Asia South East,0,0,0,3,3
2016-12-31,2016,4,Serbia and Montenegro,Europe Other,1,1,1,0,1
2016-12-31,2016,4,Sierra Leone,Africa Sub-Saharan,6,4,0,0,0
2016-12-31,2016,4,South Africa,Africa Sub-Saharan,16,14,9,0,9
2016-12-31,2016,4,South Korea,Asia East,1,1,1,0,1
2016-12-31,2016,4,Sri Lanka,Asia South,0,0,0,2,2
2016-12-31,2016,4,St Lucia,America Central and South,0,0,0,1,1
2016-12-31,2016,4,St Vincent and the Grenadines,America Central and South,0,0,0,1,1
2016-12-31,2016,4,Syria,Middle East,0,0,0,1,1
2016-12-31,2016,4,Tanzania,Africa Sub-Saharan,0,0,0,1,1
2016-12-31,2016,4,Thailand,Asia South East,0,0,0,1,1
2016-12-31,2016,4,Trinidad and Tobago,America Central and South,0,0,0,1,1
2016-12-31,2016,4,Tunisia,Africa North,0,0,0,2,2
2016-12-31,2016,4,Turkey,Europe Other,0,0,0,4,4
2016-12-31,2016,4,Ukraine,Europe Other,23,23,9,0,9
2016-12-31,2016,4,Vietnam,Asia South East,0,0,0,1,1
2017-03-31,2017,1,Afghanistan,Asia Central,0,0,0,1,1
2017-03-31,2017,1,Albania,Europe Other,161,135,63,0,63
2017-03-31,2017,1,Algeria,Africa North,0,0,0,5,5
2017-03-31,2017,1,Angola,Africa Sub-Saharan,0,0,0,1,1
2017-03-31,2017,1,Australia,Oceania,0,0,0,1,1
2017-03-31,2017,1,Bangladesh,Asia South,0,0,0,31,31
2017-03-31,2017,1,Brazil,America Central and South,2,2,2,0,2
2017-03-31,2017,1,China,Asia East,0,0,0,12,12
2017-03-31,2017,1,Egypt,Africa North,0,0,0,2,2
2017-03-31,2017,1,"Gambia, The",Africa Sub-Saharan,19,18,4,0,4
2017-03-31,2017,1,Ghana,Africa Sub-Saharan,39,38,18,1,19
2017-03-31,2017,1,Hong Kong,Asia East,0,0,0,1,1
2017-03-31,2017,1,India,Asia South,212,208,158,0,158
2017-03-31,2017,1,Iraq,Middle East,0,0,0,1,1
2017-03-31,2017,1,Ivory Coast,Africa Sub-Saharan,0,0,0,1,1
2017-03-31,2017,1,Jamaica,America Central and South,0,0,0,19,19
2017-03-31,2017,1,Japan,Asia East,0,0,0,1,1
2017-03-31,2017,1,Kenya,Africa Sub-Saharan,6,6,2,0,2
2017-03-31,2017,1,Kosovo,Europe Other,5,4,3,0,3
2017-03-31,2017,1,Liberia,Africa Sub-Saharan,2,2,2,0,2
2017-03-31,2017,1,Malawi,Africa Sub-Saharan,3,3,0,1,1
2017-03-31,2017,1,Malaysia,Asia South East,0,0,0,1,1
2017-03-31,2017,1,Mauritius,Africa Sub-Saharan,13,13,7,0,7
2017-03-31,2017,1,Mongolia,Asia East,3,3,0,0,0
2017-03-31,2017,1,Nepal,Asia South,0,0,0,6,6
2017-03-31,2017,1,New Zealand,Oceania,0,0,0,1,1
2017-03-31,2017,1,Nigeria,Africa Sub-Saharan,104,97,46,9,55
2017-03-31,2017,1,Pakistan,Asia South,0,0,0,83,83
2017-03-31,2017,1,Papua New Guinea,Oceania,0,0,0,1,1
2017-03-31,2017,1,Peru,America Central and South,2,2,2,0,2
2017-03-31,2017,1,Philippines,Asia South East,0,0,0,7,7
2017-03-31,2017,1,Senegal,Africa Sub-Saharan,0,0,0,1,1
2017-03-31,2017,1,Sierra Leone,Africa Sub-Saharan,2,2,1,0,1
2017-03-31,2017,1,South Africa,Africa Sub-Saharan,4,4,2,0,2
2017-03-31,2017,1,South Korea,Asia East,2,2,2,0,2
2017-03-31,2017,1,St Kitts and Nevis,America Central and South,0,0,0,1,1
2017-03-31,2017,1,St Lucia,America Central and South,0,0,0,1,1
2017-03-31,2017,1,St Vincent and the Grenadines,America Central and South,0,0,0,2,2
2017-03-31,2017,1,Tanzania,Africa Sub-Saharan,0,0,0,3,3
2017-03-31,2017,1,Trinidad and Tobago,America Central and South,0,0,0,1,1
2017-03-31,2017,1,Tunisia,Africa North,0,0,0,2,2
2017-03-31,2017,1,Turkey,Europe Other,0,0,0,1,1
2017-03-31,2017,1,Ukraine,Europe Other,13,10,3,0,3
2017-03-31,2017,1,United States,America North,0,0,0,1,1
2017-03-31,2017,1,Vietnam,Asia South East,0,0,0,12,12
2017-03-31,2017,1,Zimbabwe,Africa Sub-Saharan,0,0,0,5,5
2017-06-30,2017,2,Albania,Europe Other,131,127,44,0,44
2017-06-30,2017,2,Algeria,Africa North,0,0,0,4,4
2017-06-30,2017,2,Bangladesh,Asia South,0,0,0,25,25
2017-06-30,2017,2,Bosnia and Herzegovina,Europe Other,1,1,1,0,1
2017-06-30,2017,2,Brazil,America Central and South,5,5,5,0,5
2017-06-30,2017,2,Cameroon,Africa Sub-Saharan,0,0,0,1,1
2017-06-30,2017,2,China,Asia East,0,0,0,4,4
2017-06-30,2017,2,Congo (Democratic Republic),Africa Sub-Saharan,0,0,0,1,1
2017-06-30,2017,2,Eritrea,Africa Sub-Saharan,0,0,0,1,1
2017-06-30,2017,2,"Gambia, The",Africa Sub-Saharan,10,8,3,0,3
2017-06-30,2017,2,Georgia,Europe Other,0,0,0,2,2
2017-06-30,2017,2,Ghana,Africa Sub-Saharan,33,32,16,3,19
2017-06-30,2017,2,Grenada,America Central and South,0,0,0,1,1
2017-06-30,2017,2,India,Asia South,226,223,177,0,177
2017-06-30,2017,2,Iraq,Middle East,0,0,0,3,3
2017-06-30,2017,2,Israel,Middle East,0,0,0,1,1
2017-06-30,2017,2,Ivory Coast,Africa Sub-Saharan,0,0,0,2,2
2017-06-30,2017,2,Jamaica,America Central and South,0,0,0,23,23
2017-06-30,2017,2,Kenya,Africa Sub-Saharan,8,8,3,1,4
2017-06-30,2017,2,Korea (North),Asia East,0,0,0,1,1
2017-06-30,2017,2,Kosovo,Europe Other,3,3,3,0,3
2017-06-30,2017,2,Liberia,Africa Sub-Saharan,1,1,0,0,0
2017-06-30,2017,2,Malawi,Africa Sub-Saharan,3,2,1,0,1
2017-06-30,2017,2,Mali,Africa Sub-Saharan,1,1,0,0,0
2017-06-30,2017,2,Mauritius,Africa Sub-Saharan,4,4,3,0,3
2017-06-30,2017,2,Mongolia,Asia East,2,1,0,0,0
2017-06-30,2017,2,Morocco,Africa North,0,0,0,1,1
2017-06-30,2017,2,Nepal,Asia South,0,0,0,4,4
2017-06-30,2017,2,Nigeria,Africa Sub-Saharan,99,89,34,12,46
2017-06-30,2017,2,Pakistan,Asia South,0,0,0,69,69
2017-06-30,2017,2,Philippines,Asia South East,0,0,0,5,5
2017-06-30,2017,2,Sierra Leone,Africa Sub-Saharan,2,2,1,0,1
2017-06-30,2017,2,South Africa,Africa Sub-Saharan,11,11,6,0,6
2017-06-30,2017,2,Sri Lanka,Asia South,0,0,0,1,1
2017-06-30,2017,2,St Lucia,America Central and South,0,0,0,1,1
2017-06-30,2017,2,Trinidad and Tobago,America Central and South,0,0,0,3,3
2017-06-30,2017,2,Tunisia,Africa North,0,0,0,3,3
2017-06-30,2017,2,Turkey,Europe Other,0,0,0,1,1
2017-06-30,2017,2,Ukraine,Europe Other,19,18,5,0,5
2017-06-30,2017,2,Venezuela,America Central and South,0,0,0,1,1
2017-06-30,2017,2,Vietnam,Asia South East,0,0,0,12,12
2017-06-30,2017,2,Zambia,Africa Sub-Saharan,0,0,0,1,1
2017-06-30,2017,2,Zimbabwe,Africa Sub-Saharan,0,0,0,2,2
2017-09-30,2017,3,Albania,Europe Other,135,118,46,0,46
2017-09-30,2017,3,Algeria,Africa North,0,0,0,1,1
2017-09-30,2017,3,Bangladesh,Asia South,0,0,0,25,25
2017-09-30,2017,3,Bolivia,America Central and South,1,1,0,0,0
2017-09-30,2017,3,Botswana,Africa Sub-Saharan,0,0,0,2,2
2017-09-30,2017,3,Brazil,America Central and South,1,1,0,0,0
2017-09-30,2017,3,China,Asia East,0,0,0,5,5
2017-09-30,2017,3,"Gambia, The",Africa Sub-Saharan,6,6,2,1,3
2017-09-30,2017,3,Georgia,Europe Other,0,0,0,1,1
2017-09-30,2017,3,Ghana,Africa Sub-Saharan,37,31,10,1,11
2017-09-30,2017,3,India,Asia South,233,229,170,0,170
2017-09-30,2017,3,Ivory Coast,Africa Sub-Saharan,0,0,0,1,1
2017-09-30,2017,3,Jamaica,America Central and South,0,0,0,9,9
2017-09-30,2017,3,Kenya,Africa Sub-Saharan,8,8,1,0,1
2017-09-30,2017,3,Korea (North),Asia East,0,0,0,2,2
2017-09-30,2017,3,Kosovo,Europe Other,4,4,2,0,2
2017-09-30,2017,3,Lebanon,Middle East,0,0,0,1,1
2017-09-30,2017,3,Liberia,Africa Sub-Saharan,1,1,1,0,1
2017-09-30,2017,3,Malawi,Africa Sub-Saharan,4,4,2,0,2
2017-09-30,2017,3,Malaysia,Asia South East,0,0,0,1,1
2017-09-30,2017,3,Mali,Africa Sub-Saharan,1,1,0,0,0
2017-09-30,2017,3,Mauritius,Africa Sub-Saharan,15,15,9,0,9
2017-09-30,2017,3,Mongolia,Asia East,1,1,1,0,1
2017-09-30,2017,3,Morocco,Africa North,0,0,0,1,1
2017-09-30,2017,3,Namibia,Africa Sub-Saharan,0,0,0,1,1
2017-09-30,2017,3,Nepal,Asia South,0,0,0,5,5
2017-09-30,2017,3,Nigeria,Africa Sub-Saharan,117,105,42,9,51
2017-09-30,2017,3,North Macedonia,Europe Other,1,1,1,0,1
2017-09-30,2017,3,Occupied Palestinian Territories,Middle East,0,0,0,1,1
2017-09-30,2017,3,Pakistan,Asia South,0,0,0,66,66
2017-09-30,2017,3,Peru,America Central and South,1,1,0,0,0
2017-09-30,2017,3,Philippines,Asia South East,0,0,0,5,5
2017-09-30,2017,3,Serbia and Montenegro,Europe Other,1,0,0,0,0
2017-09-30,2017,3,Sierra Leone,Africa Sub-Saharan,7,6,0,0,0
2017-09-30,2017,3,South Africa,Africa Sub-Saharan,12,12,3,0,3
2017-09-30,2017,3,Sri Lanka,Asia South,0,0,0,1,1
2017-09-30,2017,3,St Lucia,America Central and South,0,0,0,1,1
2017-09-30,2017,3,St Vincent and the Grenadines,America Central and South,0,0,0,1,1
2017-09-30,2017,3,Ukraine,Europe Other,16,15,2,0,2
2017-09-30,2017,3,United States,America North,0,0,0,3,3
2017-09-30,2017,3,Vietnam,Asia South East,0,0,0,7,7
2017-09-30,2017,3,Zimbabwe,Africa Sub-Saharan,0,0,0,1,1
2017-12-31,2017,4,Albania,Europe Other,193,167,43,0,43
2017-12-31,2017,4,Algeria,Africa North,0,0,0,4,4
2017-12-31,2017,4,Armenia,Europe Other,0,0,0,1,1
2017-12-31,2017,4,Bangladesh,Asia South,0,0,0,32,32
2017-12-31,2017,4,Bolivia,America Central and South,2,2,2,0,2
2017-12-31,2017,4,Brazil,America Central and South,2,2,2,0,2
2017-12-31,2017,4,Canada,America North,0,0,0,1,1
2017-12-31,2017,4,China,Asia East,0,0,0,2,2
2017-12-31,2017,4,Colombia,America Central and South,0,0,0,1,1
2017-12-31,2017,4,Congo (Democratic Republic),Africa Sub-Saharan,0,0,0,1,1
2017-12-31,2017,4,Egypt,Africa North,0,0,0,1,1
2017-12-31,2017,4,"Gambia, The",Africa Sub-Saharan,5,5,3,0,3
2017-12-31,2017,4,Georgia,Europe Other,0,0,0,1,1
2017-12-31,2017,4,Ghana,Africa Sub-Saharan,21,19,12,2,14
2017-12-31,2017,4,India,Asia South,220,219,169,0,169
2017-12-31,2017,4,Indonesia,Asia South East,0,0,0,1,1
2017-12-31,2017,4,Jamaica,America Central and South,0,0,0,10,10
2017-12-31,2017,4,Kenya,Africa Sub-Saharan,7,7,1,0,1
2017-12-31,2017,4,Korea (North),Asia East,0,0,0,2,2
2017-12-31,2017,4,Kosovo,Europe Other,2,2,0,0,0
2017-12-31,2017,4,Lebanon,Middle East,0,0,0,1,1
2017-12-31,2017,4,Liberia,Africa Sub-Saharan,1,0,0,0,0
2017-12-31,2017,4,Malawi,Africa Sub-Saharan,5,5,0,0,0
2017-12-31,2017,4,Malaysia,Asia South East,0,0,0,1,1
2017-12-31,2017,4,Mauritius,Africa Sub-Saharan,2,2,1,0,1
2017-12-31,2017,4,Mexico,America Central and South,0,0,0,1,1
2017-12-31,2017,4,Moldova,Europe Other,1,1,0,0,0
2017-12-31,2017,4,Mongolia,Asia East,2,2,0,0,0
2017-12-31,2017,4,Morocco,Africa North,0,0,0,1,1
2017-12-31,2017,4,Namibia,Africa Sub-Saharan,0,0,0,1,1
2017-12-31,2017,4,Nepal,Asia South,0,0,0,6,6
2017-12-31,2017,4,Nigeria,Africa Sub-Saharan,106,95,30,4,34
2017-12-31,2017,4,Pakistan,Asia South,0,0,0,64,64
2017-12-31,2017,4,Philippines,Asia South East,0,0,0,3,3
2017-12-31,2017,4,Sierra Leone,Africa Sub-Saharan,2,2,1,0,1
2017-12-31,2017,4,South Africa,Africa Sub-Saharan,22,19,10,0,10
2017-12-31,2017,4,South Korea,Asia East,1,1,1,0,1
2017-12-31,2017,4,Sri Lanka,Asia South,0,0,0,2,2
2017-12-31,2017,4,St Lucia,America Central and South,0,0,0,2,2
2017-12-31,2017,4,St Vincent and the Grenadines,America Central and South,0,0,0,1,1
2017-12-31,2017,4,Thailand,Asia South East,0,0,0,1,1
2017-12-31,2017,4,Trinidad and Tobago,America Central and South,0,0,0,1,1
2017-12-31,2017,4,Tunisia,Africa North,0,0,0,3,3
2017-12-31,2017,4,Ukraine,Europe Other,23,23,3,0,3
2017-12-31,2017,4,United States,America North,0,0,0,2,2
2017-12-31,2017,4,Vietnam,Asia South East,0,0,0,16,16
2018-03-31,2018,1,Albania,Europe Other,278,251,68,0,68
2018-03-31,2018,1,Algeria,Africa North,0,0,0,3,3
2018-03-31,2018,1,Argentina,America Central and South,0,0,0,2,2
2018-03-31,2018,1,Bangladesh,Asia South,0,0,0,14,14
2018-03-31,2018,1,Brazil,America Central and South,5,5,3,0,3
2018-03-31,2018,1,Canada,America North,0,0,0,1,1
2018-03-31,2018,1,China,Asia East,0,0,0,10,10
2018-03-31,2018,1,Egypt,Africa North,0,0,0,1,1
2018-03-31,2018,1,"Gambia, The",Africa Sub-Saharan,11,10,3,0,3
2018-03-31,2018,1,Georgia,Europe Other,0,0,0,1,1
2018-03-31,2018,1,Ghana,Africa Sub-Saharan,31,27,12,1,13
2018-03-31,2018,1,Grenada,America Central and South,0,0,0,1,1
2018-03-31,2018,1,India,Asia South,168,164,100,0,100
2018-03-31,2018,1,Ivory Coast,Africa Sub-Saharan,0,0,0,1,1
2018-03-31,2018,1,Jamaica,America Central and South,0,0,0,6,6
2018-03-31,2018,1,Kazakhstan,Asia Central,0,0,0,2,2
2018-03-31,2018,1,Kenya,Africa Sub-Saharan,11,8,2,1,3
2018-03-31,2018,1,Korea (North),Asia East,0,0,0,4,4
2018-03-31,2018,1,Kosovo,Europe Other,4,3,2,0,2
2018-03-31,2018,1,Liberia,Africa Sub-Saharan,1,1,0,0,0
2018-03-31,2018,1,Malawi,Africa Sub-Saharan,5,4,0,0,0
2018-03-31,2018,1,Malaysia,Asia South East,0,0,0,1,1
2018-03-31,2018,1,Mali,Africa Sub-Saharan,1,1,0,0,0
2018-03-31,2018,1,Mauritius,Africa Sub-Saharan,8,7,5,0,5
2018-03-31,2018,1,Mongolia,Asia East,3,3,0,0,0
2018-03-31,2018,1,Morocco,Africa North,0,0,0,2,2
2018-03-31,2018,1,Mozambique,Africa Sub-Saharan,0,0,0,1,1
2018-03-31,2018,1,Namibia,Africa Sub-Saharan,0,0,0,2,2
2018-03-31,2018,1,Nepal,Asia South,0,0,0,1,1
2018-03-31,2018,1,Nicaragua,America Central and South,0,0,0,1,1
2018-03-31,2018,1,Nigeria,Africa Sub-Saharan,103,88,28,6,34
2018-03-31,2018,1,North Macedonia,Europe Other,1,1,1,0,1
2018-03-31,2018,1,Pakistan,Asia South,0,0,0,51,51
2018-03-31,2018,1,Philippines,Asia South East,0,0,0,2,2
2018-03-31,2018,1,Sierra Leone,Africa Sub-Saharan,6,4,0,0,0
2018-03-31,2018,1,Singapore,Asia South East,0,0,0,1,1
2018-03-31,2018,1,Somalia,Africa Sub-Saharan,0,0,0,1,1
2018-03-31,2018,1,South Africa,Africa Sub-Saharan,10,9,4,0,4
2018-03-31,2018,1,South Korea,Asia East,1,1,1,0,1
2018-03-31,2018,1,Sri Lanka,Asia South,0,0,0,1,1
2018-03-31,2018,1,Sudan,Africa North,0,0,0,1,1
2018-03-31,2018,1,Ukraine,Europe Other,25,25,8,0,8
2018-03-31,2018,1,United States,America North,0,0,0,3,3
2018-03-31,2018,1,Vietnam,Asia South East,0,0,0,12,12
2018-03-31,2018,1,Zambia,Africa Sub-Saharan,0,0,0,1,1
2018-03-31,2018,1,Zimbabwe,Africa Sub-Saharan,0,0,0,1,1
2018-06-30,2018,2,Afghanistan,Asia Central,0,0,0,1,1
2018-06-30,2018,2,Albania,Europe Other,189,173,89,0,89
2018-06-30,2018,2,Algeria,Africa North,0,0,0,4,4
2018-06-30,2018,2,Bangladesh,Asia South,0,0,0,10,10
2018-06-30,2018,2,Barbados,America Central and South,0,0,0,1,1
2018-06-30,2018,2,Benin,Africa Sub-Saharan,0,0,0,1,1
2018-06-30,2018,2,Bolivia,America Central and South,4,4,3,0,3
2018-06-30,2018,2,Brazil,America Central and South,5,5,5,0,5
2018-06-30,2018,2,Canada,America North,0,0,0,1,1
2018-06-30,2018,2,China,Asia East,0,0,0,2,2
2018-06-30,2018,2,Dominica,America Central and South,0,0,0,3,3
2018-06-30,2018,2,Egypt,Africa North,0,0,0,1,1
2018-06-30,2018,2,"Gambia, The",Africa Sub-Saharan,5,4,2,0,2
2018-06-30,2018,2,Georgia,Europe Other,0,0,0,1,1
2018-06-30,2018,2,Ghana,Africa Sub-Saharan,21,19,6,2,8
2018-06-30,2018,2,India,Asia South,138,135,90,0,90
2018-06-30,2018,2,Indonesia,Asia South East,0,0,0,2,2
2018-06-30,2018,2,Jamaica,America Central and South,0,0,0,3,3
2018-06-30,2018,2,Japan,Asia East,0,0,0,1,1
2018-06-30,2018,2,Kazakhstan,Asia Central,0,0,0,1,1
2018-06-30,2018,2,Kenya,Africa Sub-Saharan,5,5,0,1,1
2018-06-30,2018,2,Kosovo,Europe Other,2,1,0,0,0
2018-06-30,2018,2,Malawi,Africa Sub-Saharan,5,5,1,0,1
2018-06-30,2018,2,Malaysia,Asia South East,0,0,0,1,1
2018-06-30,2018,2,Mali,Africa Sub-Saharan,2,2,2,0,2
2018-06-30,2018,2,Mauritius,Africa Sub-Saharan,4,4,1,0,1
2018-06-30,2018,2,Mongolia,Asia East,1,1,1,0,1
2018-06-30,2018,2,Morocco,Africa North,0,0,0,2,2
2018-06-30,2018,2,Namibia,Africa Sub-Saharan,0,0,0,4,4
2018-06-30,2018,2,Nepal,Asia South,0,0,0,2,2
2018-06-30,2018,2,Nigeria,Africa Sub-Saharan,89,85,32,6,38
2018-06-30,2018,2,Occupied Palestinian Territories,Middle East,0,0,0,2,2
2018-06-30,2018,2,Pakistan,Asia South,0,0,0,49,49
2018-06-30,2018,2,Philippines,Asia South East,0,0,0,1,1
2018-06-30,2018,2,Poland,EU 8,0,0,0,1,1
2018-06-30,2018,2,Sierra Leone,Africa Sub-Saharan,4,4,2,0,2
2018-06-30,2018,2,Somalia,Africa Sub-Saharan,0,0,0,1,1
2018-06-30,2018,2,South Africa,Africa Sub-Saharan,9,8,3,0,3
2018-06-30,2018,2,South Korea,Asia East,1,1,1,0,1
2018-06-30,2018,2,Thailand,Asia South East,0,0,0,1,1
2018-06-30,2018,2,Trinidad and Tobago,America Central and South,0,0,0,1,1
2018-06-30,2018,2,Tunisia,Africa North,0,0,0,2,2
2018-06-30,2018,2,Turkey,Europe Other,0,0,0,1,1
2018-06-30,2018,2,Uganda,Africa Sub-Saharan,0,0,0,2,2
2018-06-30,2018,2,Ukraine,Europe Other,34,34,7,0,7
2018-06-30,2018,2,United States,America North,0,0,0,2,2
2018-06-30,2018,2,Vietnam,Asia South East,0,0,0,7,7
2018-06-30,2018,2,Zambia,Africa Sub-Saharan,0,0,0,1,1
2018-06-30,2018,2,Zimbabwe,Africa Sub-Saharan,0,0,0,1,1
2018-09-30,2018,3,Albania,Europe Other,203,194,76,0,76
2018-09-30,2018,3,Algeria,Africa North,0,0,0,3,3
2018-09-30,2018,3,Angola,Africa Sub-Saharan,0,0,0,1,1
2018-09-30,2018,3,Bangladesh,Asia South,0,0,0,4,4
2018-09-30,2018,3,Bolivia,America Central and South,1,1,0,0,0
2018-09-30,2018,3,Brazil,America Central and South,7,4,3,0,3
2018-09-30,2018,3,Cameroon,Africa Sub-Saharan,0,0,0,1,1
2018-09-30,2018,3,China,Asia East,0,0,0,3,3
2018-09-30,2018,3,Dominica,America Central and South,0,0,0,1,1
2018-09-30,2018,3,Dominican Republic,America Central and South,0,0,0,1,1
2018-09-30,2018,3,"Gambia, The",Africa Sub-Saharan,6,5,1,0,1
2018-09-30,2018,3,Ghana,Africa Sub-Saharan,25,25,10,2,12
2018-09-30,2018,3,Guatemala,America Central and South,0,0,0,1,1
2018-09-30,2018,3,India,Asia South,132,125,93,0,93
2018-09-30,2018,3,Jamaica,America Central and South,0,0,0,3,3
2018-09-30,2018,3,Kenya,Africa Sub-Saharan,7,7,1,1,2
2018-09-30,2018,3,Malawi,Africa Sub-Saharan,3,3,0,1,1
2018-09-30,2018,3,Mali,Africa Sub-Saharan,2,2,0,0,0
2018-09-30,2018,3,Mauritius,Africa Sub-Saharan,7,7,4,0,4
2018-09-30,2018,3,Namibia,Africa Sub-Saharan,0,0,0,3,3
2018-09-30,2018,3,Nepal,Asia South,0,0,0,3,3
2018-09-30,2018,3,Nigeria,Africa Sub-Saharan,74,65,28,3,31
2018-09-30,2018,3,Pakistan,Asia South,0,0,0,21,21
2018-09-30,2018,3,Philippines,Asia South East,0,0,0,3,3
2018-09-30,2018,3,Russia,Europe Other,0,0,0,1,1
2018-09-30,2018,3,Rwanda,Africa Sub-Saharan,0,0,0,1,1
2018-09-30,2018,3,Serbia and Montenegro,Europe Other,2,2,0,0,0
2018-09-30,2018,3,Sierra Leone,Africa Sub-Saharan,7,6,2,1,3
2018-09-30,2018,3,South Africa,Africa Sub-Saharan,9,8,4,0,4
2018-09-30,2018,3,Thailand,Asia South East,0,0,0,1,1
2018-09-30,2018,3,Tunisia,Africa North,0,0,0,1,1
2018-09-30,2018,3,Ukraine,Europe Other,25,21,5,0,5
2018-09-30,2018,3,United States,America North,0,0,0,1,1
2018-09-30,2018,3,Vietnam,Asia South East,0,0,0,7,7
2018-09-30,2018,3,Zimbabwe,Africa Sub-Saharan,0,0,0,1,1
2018-12-31,2018,4,Albania,Europe Other,168,154,53,0,53
2018-12-31,2018,4,Algeria,Africa North,0,0,0,3,3
2018-12-31,2018,4,Angola,Africa Sub-Saharan,0,0,0,2,2
2018-12-31,2018,4,Australia,Oceania,0,0,0,3,3
2018-12-31,2018,4,Bangladesh,Asia South,0,0,0,8,8
2018-12-31,2018,4,Belarus,Europe Other,0,0,0,1,1
2018-12-31,2018,4,Brazil,America Central and South,5,5,3,0,3
2018-12-31,2018,4,Canada,America North,0,0,0,1,1
2018-12-31,2018,4,China,Asia East,0,0,0,10,10
2018-12-31,2018,4,Costa Rica,America Central and South,0,0,0,1,1
2018-12-31,2018,4,Ecuador,America Central and South,2,2,1,0,1
2018-12-31,2018,4,Egypt,Africa North,0,0,0,3,3
2018-12-31,2018,4,"Gambia, The",Africa Sub-Saharan,7,6,1,0,1
2018-12-31,2018,4,Georgia,Europe Other,0,0,0,1,1
2018-12-31,2018,4,Ghana,Africa Sub-Saharan,23,21,11,1,12
2018-12-31,2018,4,India,Asia South,122,118,82,0,82
2018-12-31,2018,4,Iraq,Middle East,0,0,0,1,1
2018-12-31,2018,4,Jamaica,America Central and South,0,0,0,6,6
2018-12-31,2018,4,Kenya,Africa Sub-Saharan,4,4,0,0,0
2018-12-31,2018,4,Korea (North),Asia East,0,0,0,1,1
2018-12-31,2018,4,Kosovo,Europe Other,2,1,1,0,1
2018-12-31,2018,4,Malawi,Africa Sub-Saharan,5,5,0,0,0
2018-12-31,2018,4,Malaysia,Asia South East,0,0,0,1,1
2018-12-31,2018,4,Mauritius,Africa Sub-Saharan,6,5,2,0,2
2018-12-31,2018,4,Mexico,America Central and South,0,0,0,1,1
2018-12-31,2018,4,Mongolia,Asia East,2,2,0,0,0
2018-12-31,2018,4,Morocco,Africa North,0,0,0,4,4
2018-12-31,2018,4,Namibia,Africa Sub-Saharan,0,0,0,2,2
2018-12-31,2018,4,Nigeria,Africa Sub-Saharan,48,44,18,0,18
2018-12-31,2018,4,Pakistan,Asia South,0,0,0,10,10
2018-12-31,2018,4,Somalia,Africa Sub-Saharan,0,0,0,1,1
2018-12-31,2018,4,South Africa,Africa Sub-Saharan,13,12,5,0,5
2018-12-31,2018,4,Trinidad and Tobago,America Central and South,0,0,0,1,1
2018-12-31,2018,4,Ukraine,Europe Other,25,24,4,0,4
2018-12-31,2018,4,United States,America North,0,0,0,3,3
2018-12-31,2018,4,Vietnam,Asia South East,0,0,0,3,3
2019-03-31,2019,1,Albania,Europe Other,335,276,78,0,78
2019-03-31,2019,1,Algeria,Africa North,0,0,0,2,2
2019-03-31,2019,1,Bangladesh,Asia South,0,0,0,6,6
2019-03-31,2019,1,Bolivia,America Central and South,2,2,1,0,1
2019-03-31,2019,1,Brazil,America Central and South,9,9,5,0,5
2019-03-31,2019,1,China,Asia East,0,0,0,9,9
2019-03-31,2019,1,Congo (Democratic Republic),Africa Sub-Saharan,0,0,0,1,1
2019-03-31,2019,1,Ecuador,America Central and South,1,1,1,0,1
2019-03-31,2019,1,Egypt,Africa North,0,0,0,1,1
2019-03-31,2019,1,Eritrea,Africa Sub-Saharan,0,0,0,1,1
2019-03-31,2019,1,"Gambia, The",Africa Sub-Saharan,4,4,1,0,1
2019-03-31,2019,1,Georgia,Europe Other,0,0,0,1,1
2019-03-31,2019,1,Ghana,Africa Sub-Saharan,24,23,13,0,13
2019-03-31,2019,1,India,Asia South,120,113,62,0,62
2019-03-31,2019,1,Jamaica,America Central and South,0,0,0,1,1
2019-03-31,2019,1,Kenya,Africa Sub-Saharan,1,1,0,0,0
2019-03-31,2019,1,Kosovo,Europe Other,1,1,0,0,0
2019-03-31,2019,1,Malawi,Africa Sub-Saharan,6,4,1,0,1
2019-03-31,2019,1,Malaysia,Asia South East,0,0,0,2,2
2019-03-31,2019,1,Mali,Africa Sub-Saharan,2,1,0,0,0
2019-03-31,2019,1,Mauritius,Africa Sub-Saharan,8,8,3,0,3
2019-03-31,2019,1,Moldova,Europe Other,1,1,0,0,0
2019-03-31,2019,1,Mongolia,Asia East,2,2,0,0,0
2019-03-31,2019,1,Namibia,Africa Sub-Saharan,0,0,0,2,2
2019-03-31,2019,1,Nepal,Asia South,0,0,0,1,1
2019-03-31,2019,1,Nigeria,Africa Sub-Saharan,69,55,20,0,20
2019-03-31,2019,1,Pakistan,Asia South,0,0,0,23,23
2019-03-31,2019,1,Philippines,Asia South East,0,0,0,2,2
2019-03-31,2019,1,Sierra Leone,Africa Sub-Saharan,5,5,1,0,1
2019-03-31,2019,1,South Africa,Africa Sub-Saharan,15,14,5,0,5
2019-03-31,2019,1,St Lucia,America Central and South,0,0,0,1,1
2019-03-31,2019,1,Tanzania,Africa Sub-Saharan,0,0,0,1,1
2019-03-31,2019,1,Uganda,Africa Sub-Saharan,0,0,0,1,1
2019-03-31,2019,1,Ukraine,Europe Other,22,21,2,0,2
2019-03-31,2019,1,Vietnam,Asia South East,0,0,0,4,4
2019-06-30,2019,2,Albania,Europe Other,321,258,95,0,95
2019-06-30,2019,2,Algeria,Africa North,0,0,0,4,4
2019-06-30,2019,2,Bangladesh,Asia South,0,0,0,2,2
2019-06-30,2019,2,Bolivia,America Central and South,1,1,0,0,0
2019-06-30,2019,2,Brazil,America Central and South,8,5,2,0,2
2019-06-30,2019,2,China,Asia East,0,0,0,5,5
2019-06-30,2019,2,Ecuador,America Central and South,3,3,3,0,3
2019-06-30,2019,2,Egypt,Africa North,0,0,0,1,1
2019-06-30,2019,2,"Gambia, The",Africa Sub-Saharan,2,0,0,0,0
2019-06-30,2019,2,Ghana,Africa Sub-Saharan,20,17,7,1,8
2019-06-30,2019,2,India,Asia South,135,125,74,0,74
2019-06-30,2019,2,Israel,Middle East,0,0,0,1,1
2019-06-30,2019,2,Jamaica,America Central and South,0,0,0,1,1
2019-06-30,2019,2,Kenya,Africa Sub-Saharan,7,5,0,0,0
2019-06-30,2019,2,Korea (North),Asia East,0,0,0,1,1
2019-06-30,2019,2,Kosovo,Europe Other,4,2,2,0,2
2019-06-30,2019,2,Malawi,Africa Sub-Saharan,2,2,1,1,2
2019-06-30,2019,2,Mali,Africa Sub-Saharan,2,1,0,0,0
2019-06-30,2019,2,Mauritius,Africa Sub-Saharan,4,4,3,0,3
2019-06-30,2019,2,Mexico,America Central and South,0,0,0,1,1
2019-06-30,2019,2,Mongolia,Asia East,2,2,1,0,1
2019-06-30,2019,2,Morocco,Africa North,0,0,0,1,1
2019-06-30,2019,2,Nepal,Asia South,0,0,0,1,1
2019-06-30,2019,2,Nigeria,Africa Sub-Saharan,66,53,17,3,20
2019-06-30,2019,2,Pakistan,Asia South,0,0,0,9,9
2019-06-30,2019,2,Philippines,Asia South East,0,0,0,1,1
2019-06-30,2019,2,Sierra Leone,Africa Sub-Saharan,7,4,1,0,1
2019-06-30,2019,2,South Africa,Africa Sub-Saharan,15,11,2,0,2
2019-06-30,2019,2,Ukraine,Europe Other,24,22,4,0,4
2019-06-30,2019,2,United States,America North,0,0,0,1,1
2019-09-30,2019,3,Albania,Europe Other,216,157,60,0,60
2019-09-30,2019,3,Algeria,Africa North,0,0,0,1,1
2019-09-30,2019,3,Angola,Africa Sub-Saharan,0,0,0,1,1
2019-09-30,2019,3,Bangladesh,Asia South,0,0,0,2,2
2019-09-30,2019,3,Benin,Africa Sub-Saharan,0,0,0,1,1
2019-09-30,2019,3,Bolivia,America Central and South,7,6,2,0,2
2019-09-30,2019,3,Bosnia and Herzegovina,Europe Other,1,1,0,0,0
2019-09-30,2019,3,Brazil,America Central and South,17,16,9,0,9
2019-09-30,2019,3,China,Asia East,0,0,0,5,5
2019-09-30,2019,3,Colombia,America Central and South,0,0,0,1,1
2019-09-30,2019,3,Ecuador,America Central and South,2,2,2,0,2
2019-09-30,2019,3,Eritrea,Africa Sub-Saharan,0,0,0,1,1
2019-09-30,2019,3,"Gambia, The",Africa Sub-Saharan,12,11,3,0,3
2019-09-30,2019,3,Georgia,Europe Other,0,0,0,2,2
2019-09-30,2019,3,Ghana,Africa Sub-Saharan,29,25,8,0,8
2019-09-30,2019,3,India,Asia South,152,147,90,0,90
2019-09-30,2019,3,Jordan,Middle East,0,0,0,1,1
2019-09-30,2019,3,Kenya,Africa Sub-Saharan,14,8,4,0,4
2019-09-30,2019,3,Korea (North),Asia East,0,0,0,2,2
2019-09-30,2019,3,Kosovo,Europe Other,1,0,0,0,0
2019-09-30,2019,3,Malawi,Africa Sub-Saharan,1,1,0,0,0
2019-09-30,2019,3,Mali,Africa Sub-Saharan,1,1,0,0,0
2019-09-30,2019,3,Mauritius,Africa Sub-Saharan,17,16,9,0,9
2019-09-30,2019,3,Mongolia,Asia East,5,3,1,0,1
2019-09-30,2019,3,Morocco,Africa North,0,0,0,1,1
2019-09-30,2019,3,Namibia,Africa Sub-Saharan,0,0,0,2,2
2019-09-30,2019,3,Nigeria,Africa Sub-Saharan,93,79,24,1,25
2019-09-30,2019,3,Pakistan,Asia South,0,0,0,9,9
2019-09-30,2019,3,Philippines,Asia South East,0,0,0,2,2
2019-09-30,2019,3,Sierra Leone,Africa Sub-Saharan,10,8,1,0,1
2019-09-30,2019,3,South Africa,Africa Sub-Saharan,17,16,7,0,7
2019-09-30,2019,3,Syria,Middle East,0,0,0,2,2
2019-09-30,2019,3,Ukraine,Europe Other,25,22,1,0,1
2019-09-30,2019,3,Vietnam,Asia South East,0,0,0,3,3
2019-12-31,2019,4,Albania,Europe Other,231,163,59,0,59
2019-12-31,2019,4,Algeria,Africa North,0,0,0,1,1
2019-12-31,2019,4,Bangladesh,Asia South,0,0,0,2,2
2019-12-31,2019,4,Bolivia,America Central and South,7,7,0,0,0
2019-12-31,2019,4,Brazil,America Central and South,17,16,10,0,10
2019-12-31,2019,4,Canada,America North,0,0,0,2,2
2019-12-31,2019,4,China,Asia East,0,0,0,3,3
2019-12-31,2019,4,Ecuador,America Central and South,1,1,1,0,1
2019-12-31,2019,4,"Gambia, The",Africa Sub-Saharan,6,6,1,0,1
2019-12-31,2019,4,Georgia,Europe Other,0,0,0,1,1
2019-12-31,2019,4,Ghana,Africa Sub-Saharan,39,31,9,0,9
2019-12-31,2019,4,India,Asia South,207,200,129,0,129
2019-12-31,2019,4,Iran,Middle East,0,0,0,1,1
2019-12-31,2019,4,Kenya,Africa Sub-Saharan,7,3,0,0,0
2019-12-31,2019,4,Kosovo,Europe Other,7,6,1,0,1
2019-12-31,2019,4,Liberia,Africa Sub-Saharan,1,1,0,0,0
2019-12-31,2019,4,Malawi,Africa Sub-Saharan,3,1,0,0,0
2019-12-31,2019,4,Mali,Africa Sub-Saharan,1,1,0,0,0
2019-12-31,2019,4,Mauritius,Africa Sub-Saharan,6,5,2,0,2
2019-12-31,2019,4,Mexico,America Central and South,0,0,0,1,1
2019-12-31,2019,4,Mongolia,Asia East,2,2,1,0,1
2019-12-31,2019,4,Namibia,Africa Sub-Saharan,0,0,0,2,2
2019-12-31,2019,4,Nigeria,Africa Sub-Saharan,101,82,27,2,29
2019-12-31,2019,4,Pakistan,Asia South,0,0,0,8,8
2019-12-31,2019,4,Refugee,Other,0,0,0,1,1
2019-12-31,2019,4,Sierra Leone,Africa Sub-Saharan,5,3,2,0,2
2019-12-31,2019,4,South Africa,Africa Sub-Saharan,11,8,3,0,3
2019-12-31,2019,4,South Korea,Asia East,2,2,0,0,0
2019-12-31,2019,4,St Lucia,America Central and South,0,0,0,2,2
2019-12-31,2019,4,Ukraine,Europe Other,31,31,3,0,3
2019-12-31,2019,4,United States,America North,0,0,0,1,1
2020-03-31,2020,1,Albania,Europe Other,235,161,55,0,55
2020-03-31,2020,1,Bangladesh,Asia South,0,0,0,3,3
2020-03-31,2020,1,Barbados,America Central and South,0,0,0,1,1
2020-03-31,2020,1,Bolivia,America Central and South,4,3,0,0,0
2020-03-31,2020,1,Brazil,America Central and South,34,32,20,0,20
2020-03-31,2020,1,China,Asia East,0,0,0,1,1
2020-03-31,2020,1,Colombia,America Central and South,0,0,0,1,1
2020-03-31,2020,1,"Gambia, The",Africa Sub-Saharan,10,7,3,0,3
2020-03-31,2020,1,Ghana,Africa Sub-Saharan,27,24,7,1,8
2020-03-31,2020,1,India,Asia South,196,189,128,0,128
2020-03-31,2020,1,Indonesia,Asia South East,0,0,0,1,1
2020-03-31,2020,1,Jamaica,America Central and South,0,0,0,2,2
2020-03-31,2020,1,Kenya,Africa Sub-Saharan,13,11,0,0,0
2020-03-31,2020,1,Kosovo,Europe Other,2,1,0,0,0
2020-03-31,2020,1,Liberia,Africa Sub-Saharan,1,1,0,0,0
2020-03-31,2020,1,Malawi,Africa Sub-Saharan,2,2,0,0,0
2020-03-31,2020,1,Malaysia,Asia South East,0,0,0,1,1
2020-03-31,2020,1,Mali,Africa Sub-Saharan,2,2,0,0,0
2020-03-31,2020,1,Mauritius,Africa Sub-Saharan,5,5,4,0,4
2020-03-31,2020,1,Mongolia,Asia East,4,3,1,0,1
2020-03-31,2020,1,Namibia,Africa Sub-Saharan,0,0,0,3,3
2020-03-31,2020,1,Nigeria,Africa Sub-Saharan,97,78,22,0,22
2020-03-31,2020,1,Pakistan,Asia South,0,0,0,10,10
2020-03-31,2020,1,Philippines,Asia South East,0,0,0,1,1
2020-03-31,2020,1,Sierra Leone,Africa Sub-Saharan,7,6,1,0,1
2020-03-31,2020,1,South Africa,Africa Sub-Saharan,18,17,7,0,7
2020-03-31,2020,1,Trinidad and Tobago,America Central and South,0,0,0,1,1
2020-03-31,2020,1,Ukraine,Europe Other,31,28,5,0,5
2020-03-31,2020,1,United States,America North,0,0,0,1,1
2020-06-30,2020,2,Albania,Europe Other,121,68,19,0,19
2020-06-30,2020,2,Bangladesh,Asia South,0,0,0,1,1
2020-06-30,2020,2,Brazil,America Central and South,6,5,4,0,4
2020-06-30,2020,2,China,Asia East,0,0,0,1,1
2020-06-30,2020,2,"Gambia, The",Africa Sub-Saharan,6,6,1,0,1
2020-06-30,2020,2,Ghana,Africa Sub-Saharan,11,8,2,0,2
2020-06-30,2020,2,India,Asia South,72,70,41,0,41
2020-06-30,2020,2,Jamaica,America Central and South,0,0,0,1,1
2020-06-30,2020,2,Kenya,Africa Sub-Saharan,7,4,0,0,0
2020-06-30,2020,2,Kosovo,Europe Other,1,1,1,0,1
2020-06-30,2020,2,Liberia,Africa Sub-Saharan,1,1,0,0,0
2020-06-30,2020,2,Mali,Africa Sub-Saharan,1,1,0,0,0
2020-06-30,2020,2,Mauritius,Africa Sub-Saharan,5,3,2,0,2
2020-06-30,2020,2,Mongolia,Asia East,2,2,1,0,1
2020-06-30,2020,2,Namibia,Africa Sub-Saharan,0,0,0,1,1
2020-06-30,2020,2,Nigeria,Africa Sub-Saharan,41,32,9,1,10
2020-06-30,2020,2,Pakistan,Asia South,0,0,0,7,7
2020-06-30,2020,2,Senegal,Africa Sub-Saharan,0,0,0,1,1
2020-06-30,2020,2,Sierra Leone,Africa Sub-Saharan,2,2,0,0,0
2020-06-30,2020,2,South Africa,Africa Sub-Saharan,5,4,2,0,2
2020-06-30,2020,2,Ukraine,Europe Other,17,14,1,0,1
2020-09-30,2020,3,Albania,Europe Other,144,104,23,0,23
2020-09-30,2020,3,Algeria,Africa North,0,0,0,1,1
2020-09-30,2020,3,Bangladesh,Asia South,0,0,0,2,2
2020-09-30,2020,3,Brazil,America Central and South,9,9,8,0,8
2020-09-30,2020,3,Canada,America North,0,0,0,1,1
2020-09-30,2020,3,"Gambia, The",Africa Sub-Saharan,8,7,0,0,0
2020-09-30,2020,3,Ghana,Africa Sub-Saharan,6,4,2,0,2
2020-09-30,2020,3,India,Asia South,73,68,33,0,33
2020-09-30,2020,3,Kenya,Africa Sub-Saharan,5,3,0,0,0
2020-09-30,2020,3,Kosovo,Europe Other,2,2,1,0,1
2020-09-30,2020,3,Liberia,Africa Sub-Saharan,2,2,0,0,0
2020-09-30,2020,3,Mali,Africa Sub-Saharan,6,5,0,0,0
2020-09-30,2020,3,Mauritius,Africa Sub-Saharan,3,3,1,0,1
2020-09-30,2020,3,Mongolia,Asia East,4,3,0,0,0
2020-09-30,2020,3,Namibia,Africa Sub-Saharan,0,0,0,1,1
2020-09-30,2020,3,Nepal,Asia South,0,0,0,1,1
2020-09-30,2020,3,Nigeria,Africa Sub-Saharan,22,17,4,0,4
2020-09-30,2020,3,Pakistan,Asia South,0,0,0,8,8
2020-09-30,2020,3,Sierra Leone,Africa Sub-Saharan,3,2,0,0,0
2020-09-30,2020,3,South Africa,Africa Sub-Saharan,5,5,3,0,3
2020-09-30,2020,3,Ukraine,Europe Other,9,9,0,0,0
2020-09-30,2020,3,United States,America North,0,0,0,1,1
2020-12-31,2020,4,Albania,Europe Other,141,77,31,0,31
2020-12-31,2020,4,Bangladesh,Asia South,0,0,0,1,1
2020-12-31,2020,4,Brazil,America Central and South,1,1,1,0,1
2020-12-31,2020,4,"Gambia, The",Africa Sub-Saharan,6,4,2,0,2
2020-12-31,2020,4,Georgia,Europe Other,0,0,0,1,1
2020-12-31,2020,4,Ghana,Africa Sub-Saharan,9,8,2,0,2
2020-12-31,2020,4,India,Asia South,98,93,30,0,30
2020-12-31,2020,4,Kenya,Africa Sub-Saharan,1,0,0,0,0
2020-12-31,2020,4,Kosovo,Europe Other,1,0,0,0,0
2020-12-31,2020,4,Liberia,Africa Sub-Saharan,1,1,0,0,0
2020-12-31,2020,4,Malawi,Africa Sub-Saharan,1,1,0,0,0
2020-12-31,2020,4,Mali,Africa Sub-Saharan,2,1,0,0,0
2020-12-31,2020,4,Mauritius,Africa Sub-Saharan,1,1,0,0,0
2020-12-31,2020,4,Namibia,Africa Sub-Saharan,0,0,0,1,1
2020-12-31,2020,4,Nigeria,Africa Sub-Saharan,37,26,8,1,9
2020-12-31,2020,4,Pakistan,Asia South,0,0,0,9,9
2020-12-31,2020,4,Sierra Leone,Africa Sub-Saharan,7,6,2,0,2
2020-12-31,2020,4,South Africa,Africa Sub-Saharan,8,6,1,0,1
2020-12-31,2020,4,South Korea,Asia East,1,1,1,0,1
2020-12-31,2020,4,Ukraine,Europe Other,8,8,1,0,1
2021-03-31,2021,1,Albania,Europe Other,147,88,39,0,39
2021-03-31,2021,1,Bolivia,America Central and South,1,1,0,0,0
2021-03-31,2021,1,Botswana,Africa Sub-Saharan,0,0,0,1,1
2021-03-31,2021,1,Brazil,America Central and South,9,6,6,0,6
2021-03-31,2021,1,"Gambia, The",Africa Sub-Saharan,4,3,1,0,1
2021-03-31,2021,1,Ghana,Africa Sub-Saharan,14,11,5,0,5
2021-03-31,2021,1,India,Asia South,60,55,27,0,27
2021-03-31,2021,1,Iraq,Middle East,0,0,0,1,1
2021-03-31,2021,1,Jamaica,America Central and South,0,0,0,5,5
2021-03-31,2021,1,Kenya,Africa Sub-Saharan,8,4,0,0,0
2021-03-31,2021,1,Korea (North),Asia East,0,0,0,1,1
2021-03-31,2021,1,Malawi,Africa Sub-Saharan,1,0,0,0,0
2021-03-31,2021,1,Mauritius,Africa Sub-Saharan,4,2,1,0,1
2021-03-31,2021,1,Mongolia,Asia East,3,2,0,0,0
2021-03-31,2021,1,Nigeria,Africa Sub-Saharan,34,21,11,0,11
2021-03-31,2021,1,Pakistan,Asia South,0,0,0,3,3
2021-03-31,2021,1,Sierra Leone,Africa Sub-Saharan,6,5,0,0,0
2021-03-31,2021,1,Somalia,Africa Sub-Saharan,0,0,0,1,1
2021-03-31,2021,1,South Africa,Africa Sub-Saharan,7,7,3,0,3
2021-03-31,2021,1,Ukraine,Europe Other,16,15,3,0,3
2021-06-30,2021,2,Albania,Europe Other,124,67,24,0,24
2021-06-30,2021,2,Bolivia,America Central and South,1,1,0,0,0
2021-06-30,2021,2,Brazil,America Central and South,7,7,5,0,5
2021-06-30,2021,2,Ecuador,America Central and South,1,1,0,0,0
2021-06-30,2021,2,"Gambia, The",Africa Sub-Saharan,3,3,1,0,1
2021-06-30,2021,2,Ghana,Africa Sub-Saharan,12,10,5,0,5
2021-06-30,2021,2,India,Asia South,47,46,26,0,26
2021-06-30,2021,2,Iraq,Middle East,0,0,0,1,1
2021-06-30,2021,2,Jamaica,America Central and South,0,0,0,1,1
2021-06-30,2021,2,Kenya,Africa Sub-Saharan,6,3,0,0,0
2021-06-30,2021,2,Kosovo,Europe Other,3,0,0,0,0
2021-06-30,2021,2,Mali,Africa Sub-Saharan,1,0,0,0,0
2021-06-30,2021,2,Mongolia,Asia East,1,1,0,0,0
2021-06-30,2021,2,Namibia,Africa Sub-Saharan,0,0,0,1,1
2021-06-30,2021,2,Nepal,Asia South,0,0,0,1,1
2021-06-30,2021,2,Nigeria,Africa Sub-Saharan,32,18,1,0,1
2021-06-30,2021,2,Pakistan,Asia South,0,0,0,2,2
2021-06-30,2021,2,Sierra Leone,Africa Sub-Saharan,5,3,0,0,0
2021-06-30,2021,2,South Africa,Africa Sub-Saharan,4,4,1,0,1
2021-06-30,2021,2,Thailand,Asia South East,0,0,0,1,1
2021-06-30,2021,2,Ukraine,Europe Other,9,6,4,0,4
2021-06-30,2021,2,United States,America North,0,0,0,1,1
2021-06-30,2021,2,Vietnam,Asia South East,0,0,0,5,5
2021-09-30,2021,3,Albania,Europe Other,109,52,27,0,27
2021-09-30,2021,3,Algeria,Africa North,0,0,0,1,1
2021-09-30,2021,3,Brazil,America Central and South,5,5,3,0,3
2021-09-30,2021,3,China,Asia East,0,0,0,1,1
2021-09-30,2021,3,"Gambia, The",Africa Sub-Saharan,4,4,1,0,1
2021-09-30,2021,3,Ghana,Africa Sub-Saharan,3,2,0,0,0
2021-09-30,2021,3,India,Asia South,52,50,22,0,22
2021-09-30,2021,3,Jamaica,America Central and South,0,0,0,1,1
2021-09-30,2021,3,Kenya,Africa Sub-Saharan,8,4,0,0,0
2021-09-30,2021,3,Kosovo,Europe Other,3,2,1,0,1
2021-09-30,2021,3,Mali,Africa Sub-Saharan,5,3,0,0,0
2021-09-30,2021,3,Mauritius,Africa Sub-Saharan,3,2,0,0,0
2021-09-30,2021,3,Mongolia,Asia East,1,1,0,0,0
2021-09-30,2021,3,Nigeria,Africa Sub-Saharan,24,18,7,0,7
2021-09-30,2021,3,Pakistan,Asia South,0,0,0,4,4
2021-09-30,2021,3,Sierra Leone,Africa Sub-Saharan,4,3,0,0,0
2021-09-30,2021,3,South Africa,Africa Sub-Saharan,6,5,0,0,0
2021-09-30,2021,3,Ukraine,Europe Other,7,6,6,0,6
2021-09-30,2021,3,Vietnam,Asia South East,0,0,0,2,2
2021-12-31,2021,4,Albania,Europe Other,136,73,34,0,34
2021-12-31,2021,4,Bangladesh,Asia South,0,0,0,1,1
2021-12-31,2021,4,Bolivia,America Central and South,3,3,2,0,2
2021-12-31,2021,4,Brazil,America Central and South,15,12,6,0,6
2021-12-31,2021,4,Ecuador,America Central and South,1,1,0,0,0
2021-12-31,2021,4,"Gambia, The",Africa Sub-Saharan,5,3,0,0,0
2021-12-31,2021,4,Ghana,Africa Sub-Saharan,10,8,2,0,2
2021-12-31,2021,4,India,Asia South,54,52,36,0,36
2021-12-31,2021,4,Kenya,Africa Sub-Saharan,5,2,0,0,0
2021-12-31,2021,4,Kosovo,Europe Other,7,6,4,0,4
2021-12-31,2021,4,Liberia,Africa Sub-Saharan,1,1,0,0,0
2021-12-31,2021,4,Malawi,Africa Sub-Saharan,2,2,1,0,1
2021-12-31,2021,4,Mauritius,Africa Sub-Saharan,2,1,1,0,1
2021-12-31,2021,4,Morocco,Africa North,0,0,0,1,1
2021-12-31,2021,4,Nigeria,Africa Sub-Saharan,27,18,3,0,3
2021-12-31,2021,4,Pakistan,Asia South,0,0,0,1,1
2021-12-31,2021,4,Philippines,Asia South East,0,0,0,2,2
2021-12-31,2021,4,Sierra Leone,Africa Sub-Saharan,9,6,0,0,0
2021-12-31,2021,4,South Africa,Africa Sub-Saharan,5,3,0,0,0
2021-12-31,2021,4,Ukraine,Europe Other,16,15,12,0,12
2022-03-31,2022,1,Albania,Europe Other,196,74,39,0,39
2022-03-31,2022,1,Brazil,America Central and South,7,7,6,0,6
2022-03-31,2022,1,Ecuador,America Central and South,1,1,0,0,0
2022-03-31,2022,1,"Gambia, The",Africa Sub-Saharan,1,1,0,0,0
2022-03-31,2022,1,Ghana,Africa Sub-Saharan,7,6,3,0,3
2022-03-31,2022,1,India,Asia South,58,57,36,0,36
2022-03-31,2022,1,Liberia,Africa Sub-Saharan,1,1,0,0,0
2022-03-31,2022,1,Mauritius,Africa Sub-Saharan,1,1,0,0,0
2022-03-31,2022,1,Namibia,Africa Sub-Saharan,0,0,0,2,2
2022-03-31,2022,1,Nigeria,Africa Sub-Saharan,23,17,8,0,8
2022-03-31,2022,1,Philippines,Asia South East,0,0,0,1,1
2022-03-31,2022,1,Russia,Europe Other,0,0,0,1,1
2022-03-31,2022,1,Sierra Leone,Africa Sub-Saharan,4,4,0,0,0
2022-03-31,2022,1,South Africa,Africa Sub-Saharan,2,1,0,0,0
2022-03-31,2022,1,Ukraine,Europe Other,1,1,1,0,1
2022-03-31,2022,1,United States,America North,0,0,0,1,1
2022-06-30,2022,2,Albania,Europe Other,178,96,35,0,35
2022-06-30,2022,2,Bolivia,America Central and South,2,1,1,0,1
2022-06-30,2022,2,Brazil,America Central and South,9,9,7,0,7
2022-06-30,2022,2,El Salvador,America Central and South,0,0,0,1,1
2022-06-30,2022,2,"Gambia, The",Africa Sub-Saharan,4,2,0,0,0
2022-06-30,2022,2,Ghana,Africa Sub-Saharan,5,3,1,0,1
2022-06-30,2022,2,India,Asia South,70,66,38,0,38
2022-06-30,2022,2,Kenya,Africa Sub-Saharan,6,3,1,0,1
2022-06-30,2022,2,Kosovo,Europe Other,1,1,1,0,1
2022-06-30,2022,2,Mali,Africa Sub-Saharan,2,1,0,0,0
2022-06-30,2022,2,Mauritius,Africa Sub-Saharan,1,1,0,0,0
2022-06-30,2022,2,Nigeria,Africa Sub-Saharan,22,14,1,0,1
2022-06-30,2022,2,Poland,EU 8,0,0,0,1,1
2022-06-30,2022,2,Sierra Leone,Africa Sub-Saharan,4,1,0,0,0
2022-06-30,2022,2,United States,America North,0,0,0,1,1
2022-09-30,2022,3,Albania,Europe Other,151,83,18,0,18
2022-09-30,2022,3,Brazil,America Central and South,3,3,2,0,2
2022-09-30,2022,3,"Gambia, The",Africa Sub-Saharan,3,2,1,0,1
2022-09-30,2022,3,Ghana,Africa Sub-Saharan,6,2,0,0,0
2022-09-30,2022,3,India,Asia South,52,49,33,0,33
2022-09-30,2022,3,Kenya,Africa Sub-Saharan,1,0,0,0,0
2022-09-30,2022,3,Liberia,Africa Sub-Saharan,1,1,0,0,0
2022-09-30,2022,3,Mali,Africa Sub-Saharan,3,0,0,0,0
2022-09-30,2022,3,Mauritius,Africa Sub-Saharan,1,1,1,0,1
2022-09-30,2022,3,Morocco,Africa North,0,0,0,1,1
2022-09-30,2022,3,Namibia,Africa Sub-Saharan,0,0,0,2,2
2022-09-30,2022,3,Nigeria,Africa Sub-Saharan,29,14,2,0,2
2022-09-30,2022,3,Pakistan,Asia South,0,0,0,1,1
2022-09-30,2022,3,Sierra Leone,Africa Sub-Saharan,4,4,0,0,0
2022-09-30,2022,3,South Africa,Africa Sub-Saharan,4,3,1,0,1
2022-12-31,2022,4,Albania,Europe Other,223,134,53,0,53
2022-12-31,2022,4,Bangladesh,Asia South,0,0,0,2,2
2022-12-31,2022,4,Brazil,America Central and South,21,19,17,0,17
2022-12-31,2022,4,"Gambia, The",Africa Sub-Saharan,5,1,0,0,0
2022-12-31,2022,4,Ghana,Africa Sub-Saharan,8,5,0,0,0
2022-12-31,2022,4,India,Asia South,47,44,31,0,31
2022-12-31,2022,4,Kenya,Africa Sub-Saharan,6,4,3,0,3
2022-12-31,2022,4,Kosovo,Europe Other,1,1,1,0,1
2022-12-31,2022,4,Mali,Africa Sub-Saharan,3,2,0,0,0
2022-12-31,2022,4,Mauritius,Africa Sub-Saharan,2,1,1,0,1
2022-12-31,2022,4,Mongolia,Asia East,2,2,0,0,0
2022-12-31,2022,4,Namibia,Africa Sub-Saharan,0,0,0,3,3
2022-12-31,2022,4,Nigeria,Africa Sub-Saharan,30,18,2,0,2
2022-12-31,2022,4,Pakistan,Asia South,0,0,0,1,1
2022-12-31,2022,4,Philippines,Asia South East,0,0,0,2,2
2022-12-31,2022,4,Poland,EU 8,0,0,0,2,2
2022-12-31,2022,4,Sierra Leone,Africa Sub-Saharan,10,5,0,0,0
2022-12-31,2022,4,South Africa,Africa Sub-Saharan,6,5,2,0,2
2022-12-31,2022,4,Ukraine,Europe Other,2,0,0,0,0
2022-12-31,2022,4,Vietnam,Asia South East,0,0,0,1,1
2022-12-31,2022,4,Zimbabwe,Africa Sub-Saharan,0,0,0,1,1
2023-03-31,2023,1,Albania,Europe Other,488,375,187,0,187
2023-03-31,2023,1,Algeria,Africa North,0,0,0,1,1
2023-03-31,2023,1,Bolivia,America Central and South,2,1,1,0,1
2023-03-31,2023,1,Brazil,America Central and South,22,22,19,0,19
2023-03-31,2023,1,China,Asia East,0,0,0,1,1
2023-03-31,2023,1,Ecuador,America Central and South,1,1,0,0,0
2023-03-31,2023,1,"Gambia, The",Africa Sub-Saharan,7,2,1,0,1
2023-03-31,2023,1,Ghana,Africa Sub-Saharan,7,5,3,0,3
2023-03-31,2023,1,India,Asia South,75,72,66,0,66
2023-03-31,2023,1,Iraq,Middle East,0,0,0,2,2
2023-03-31,2023,1,Kenya,Africa Sub-Saharan,3,1,0,0,0
2023-03-31,2023,1,Kosovo,Europe Other,1,0,0,0,0
2023-03-31,2023,1,Mali,Africa Sub-Saharan,1,0,0,0,0
2023-03-31,2023,1,Mauritius,Africa Sub-Saharan,2,2,1,0,1
2023-03-31,2023,1,Nigeria,Africa Sub-Saharan,19,15,3,0,3
2023-03-31,2023,1,Pakistan,Asia South,0,0,0,2,2
2023-03-31,2023,1,Philippines,Asia South East,0,0,0,1,1
2023-03-31,2023,1,Poland,EU 8,0,0,0,1,1
2023-03-31,2023,1,Sierra Leone,Africa Sub-Saharan,4,2,0,0,0
2023-03-31,2023,1,South Africa,Africa Sub-Saharan,5,4,0,0,0
2023-03-31,2023,1,Sri Lanka,Asia South,0,0,0,1,1
2023-03-31,2023,1,Stateless,Other,0,0,0,1,1
2023-03-31,2023,1,Thailand,Asia South East,0,0,0,1,1
2023-03-31,2023,1,Ukraine,Europe Other,2,0,0,0,0
2023-06-30,2023,2,Albania,Europe Other,1524,1343,991,0,991
2023-06-30,2023,2,Algeria,Africa North,0,0,0,3,3
2023-06-30,2023,2,Bolivia,America Central and South,2,2,1,0,1
2023-06-30,2023,2,Botswana,Africa Sub-Saharan,0,0,0,1,1
2023-06-30,2023,2,Brazil,America Central and South,28,28,25,0,25
2023-06-30,2023,2,Dominica,America Central and South,0,0,0,2,2
2023-06-30,2023,2,Ecuador,America Central and South,1,1,0,0,0
2023-06-30,2023,2,"Gambia, The",Africa Sub-Saharan,12,9,1,0,1
2023-06-30,2023,2,Ghana,Africa Sub-Saharan,6,6,1,0,1
2023-06-30,2023,2,India,Asia South,167,155,95,0,95
2023-06-30,2023,2,Kenya,Africa Sub-Saharan,10,6,1,0,1
2023-06-30,2023,2,Kosovo,Europe Other,2,1,1,0,1
2023-06-30,2023,2,Liberia,Africa Sub-Saharan,1,1,0,0,0
2023-06-30,2023,2,Mali,Africa Sub-Saharan,4,1,0,0,0
2023-06-30,2023,2,Mauritius,Africa Sub-Saharan,2,0,0,0,0
2023-06-30,2023,2,Morocco,Africa North,0,0,0,1,1
2023-06-30,2023,2,Nigeria,Africa Sub-Saharan,90,46,16,0,16
2023-06-30,2023,2,Philippines,Asia South East,0,0,0,1,1
2023-06-30,2023,2,Sierra Leone,Africa Sub-Saharan,6,0,0,0,0
2023-06-30,2023,2,South Africa,Africa Sub-Saharan,5,1,1,0,1
2023-06-30,2023,2,St Kitts and Nevis,America Central and South,0,0,0,1,1
2023-06-30,2023,2,Syria,Middle East,0,0,0,1,1
2023-06-30,2023,2,Thailand,Asia South East,0,0,0,1,1
2023-06-30,2023,2,Tunisia,Africa North,0,0,0,5,5
2023-06-30,2023,2,Ukraine,Europe Other,9,1,0,0,0
2023-06-30,2023,2,United States,America North,0,0,0,1,1
2023-09-30,2023,3,Albania,Europe Other,1158,1083,640,0,640
2023-09-30,2023,3,Bangladesh,Asia South,0,0,0,7,7
2023-09-30,2023,3,Bolivia,America Central and South,3,2,0,0,0
2023-09-30,2023,3,Brazil,America Central and South,51,50,35,0,35
2023-09-30,2023,3,Canada,America North,0,0,0,3,3
2023-09-30,2023,3,China,Asia East,0,0,0,1,1
2023-09-30,2023,3,Ecuador,America Central and South,1,0,0,0,0
2023-09-30,2023,3,Egypt,Africa North,0,0,0,4,4
2023-09-30,2023,3,"Gambia, The",Africa Sub-Saharan,22,17,2,0,2
2023-09-30,2023,3,Ghana,Africa Sub-Saharan,30,18,5,0,5
2023-09-30,2023,3,India,Asia South,241,219,109,0,109
2023-09-30,2023,3,Iraq,Middle East,0,0,0,3,3
2023-09-30,2023,3,Kenya,Africa Sub-Saharan,28,14,4,0,4
2023-09-30,2023,3,Kosovo,Europe Other,5,5,2,0,2
2023-09-30,2023,3,Liberia,Africa Sub-Saharan,1,1,0,0,0
2023-09-30,2023,3,Malawi,Africa Sub-Saharan,1,1,0,0,0
2023-09-30,2023,3,Mali,Africa Sub-Saharan,7,2,1,0,1
2023-09-30,2023,3,Mauritius,Africa Sub-Saharan,7,4,0,0,0
2023-09-30,2023,3,Mongolia,Asia East,2,2,0,0,0
2023-09-30,2023,3,Morocco,Africa North,0,0,0,1,1
2023-09-30,2023,3,Nigeria,Africa Sub-Saharan,167,103,30,0,30
2023-09-30,2023,3,North Macedonia,Europe Other,2,2,1,0,1
2023-09-30,2023,3,Pakistan,Asia South,0,0,0,7,7
2023-09-30,2023,3,Poland,EU 8,0,0,0,1,1
2023-09-30,2023,3,Romania,EU 2,0,0,0,2,2
2023-09-30,2023,3,Sierra Leone,Africa Sub-Saharan,18,12,1,0,1
2023-09-30,2023,3,Somalia,Africa Sub-Saharan,0,0,0,1,1
2023-09-30,2023,3,South Africa,Africa Sub-Saharan,7,4,2,0,2
2023-09-30,2023,3,St Kitts and Nevis,America Central and South,0,0,0,1,1
2023-09-30,2023,3,Trinidad and Tobago,America Central and South,0,0,0,1,1
2023-09-30,2023,3,Ukraine,Europe Other,123,0,0,0,0
