Year,Quarter,Reasonable.grounds,Disqualifications,Conclusive.grounds,Total
2021,NA,183,0,97,280
NA,Q1,41,0,42,83
NA,Q2,42,0,23,65
NA,Q3,47,0,17,64
NA,Q4,53,0,15,68
2022,NA,167,0,71,238
NA,Q1,31,0,15,46
NA,Q2,37,0,21,58
NA,Q3,55,0,18,73
NA,Q4,44,0,17,61
2023,NA,259,0,97,356
NA,Q1,58,0,27,85
NA,Q2,74,0,29,103
NA,Q3,127,0,41,168
